"","cdatetime","district","crime_level","longitude","latitude","registry_number","sum_acomulated","mean_acomulated"
"1",2006-01-01,3,5,-121.3914158,38.55042047,1,5,5
"2",2006-01-01,5,7,-121.4901858,38.47350069,2,12,6
"3",2006-01-01,2,5,-121.4621009,38.65784584,3,17,5.66666666666667
"4",2006-01-01,6,7,-121.4269508,38.50677377,4,24,6
"5",2006-01-01,2,7,-121.3846125,38.6374478,5,31,6.2
"6",2006-01-01,6,7,-121.4513383,38.52697863,6,38,6.33333333333333
"7",2006-01-01,4,7,-121.4875774,38.537173,7,45,6.42857142857143
"8",2006-01-01,3,4,-121.4618826,38.56433456,8,49,6.125
"9",2006-01-01,2,7,-121.3846125,38.6374478,9,56,6.22222222222222
"10",2006-01-01,1,5,-121.4918375,38.60960217,10,61,6.1
"11",2006-01-01,6,6,-121.4546045,38.55426406,11,67,6.09090909090909
"12",2006-01-01,6,7,-121.4314528,38.52816497,12,74,6.16666666666667
"13",2006-01-01,4,5,-121.5488201,38.51092155,13,79,6.07692307692308
"14",2006-01-01,3,7,-121.4142729,38.55611545,14,86,6.14285714285714
"15",2006-01-01,6,7,-121.3923987,38.50398051,15,93,6.2
"16",2006-01-01,6,4,-121.4495097,38.54152896,16,97,6.0625
"17",2006-01-01,6,1,-121.4234749,38.51657327,17,98,5.76470588235294
"18",2006-01-01,3,6,-121.5011657,38.58184562,18,104,5.77777777777778
"19",2006-01-01,6,7,-121.4572067,38.54270763,19,111,5.84210526315789
"20",2006-01-01,4,7,-121.5203609,38.52459987,20,118,5.9
"21",2006-01-01,5,7,-121.4423777,38.44659211,21,125,5.95238095238095
"22",2006-01-01,2,7,-121.423349,38.59664183,22,132,6
"23",2006-01-01,4,4,-121.5291027,38.51512387,23,136,5.91304347826087
"24",2006-01-01,2,7,-121.4560449,38.65660112,24,143,5.95833333333333
"25",2006-01-01,5,1,-121.4095243,38.44281523,25,144,5.76
"26",2006-01-01,6,5,-121.4332827,38.5438039,26,149,5.73076923076923
"27",2006-01-01,5,7,-121.4547389,38.47121906,27,156,5.77777777777778
"28",2006-01-01,4,4,-121.5123309,38.5564521,28,160,5.71428571428571
"29",2006-01-01,5,5,-121.4965602,38.49535335,29,165,5.68965517241379
"30",2006-01-01,2,4,-121.4375169,38.64717373,30,169,5.63333333333333
"31",2006-01-01,4,2,-121.5354477,38.47889498,31,171,5.51612903225806
"32",2006-01-01,2,7,-121.444642,38.63734742,32,178,5.5625
"33",2006-01-01,3,7,-121.4767958,38.57289613,33,185,5.60606060606061
"34",2006-01-01,6,5,-121.3854286,38.51436734,34,190,5.58823529411765
"35",2006-01-01,4,1,-121.5215057,38.47948616,35,191,5.45714285714286
"36",2006-01-01,1,6,-121.5259008,38.65994218,36,197,5.47222222222222
"37",2006-01-01,1,2,-121.5187927,38.60893745,37,199,5.37837837837838
"38",2006-01-01,3,5,-121.484429,38.57084621,38,204,5.36842105263158
"39",2006-01-01,3,3,-121.4876958,38.57815667,39,207,5.30769230769231
"40",2006-01-01,1,7,-121.5341593,38.64378844,40,214,5.35
"41",2006-01-01,1,7,-121.4857344,38.62798948,41,221,5.39024390243902
"42",2006-01-01,1,7,-121.5370613,38.61153542,42,228,5.42857142857143
"43",2006-01-01,3,4,-121.4930384,38.57999251,43,232,5.3953488372093
"44",2006-01-01,3,7,-121.4978798,38.59540732,44,239,5.43181818181818
"45",2006-01-01,6,8,-121.4296507,38.51526387,45,247,5.48888888888889
"46",2006-01-01,2,5,-121.4577585,38.65737252,46,252,5.47826086956522
"47",2006-01-01,6,6,-121.434789,38.52799185,47,258,5.48936170212766
"48",2006-01-01,3,3,-121.4852542,38.56796664,48,261,5.4375
"49",2006-01-01,4,7,-121.4776262,38.50009398,49,268,5.46938775510204
"50",2006-01-01,6,2,-121.4282497,38.54138742,50,270,5.4
"51",2006-01-01,4,1,-121.4740915,38.49609085,51,271,5.31372549019608
"52",2006-01-01,4,5,-121.5195294,38.52973955,52,276,5.30769230769231
"53",2006-01-01,5,5,-121.4265274,38.46637324,53,281,5.30188679245283
"54",2006-01-01,4,5,-121.5255605,38.51538948,54,286,5.2962962962963
"55",2006-01-01,3,7,-121.4661967,38.57905906,55,293,5.32727272727273
"56",2006-01-01,1,8,-121.4755269,38.63036289,56,301,5.375
"57",2006-01-01,6,7,-121.4333041,38.50632179,57,308,5.40350877192982
"58",2006-01-01,5,8,-121.4581933,38.47400047,58,316,5.44827586206897
"59",2006-01-01,3,3,-121.5051437,38.57724403,59,319,5.40677966101695
"60",2006-01-01,3,5,-121.470553,38.57419952,60,324,5.4
"61",2006-01-01,3,2,-121.4970836,38.57881567,61,326,5.34426229508197
"62",2006-01-01,3,5,-121.4106138,38.55456463,62,331,5.33870967741935
"63",2006-01-01,6,3,-121.4309007,38.52199211,63,334,5.3015873015873
"64",2006-01-01,1,7,-121.5264198,38.62453557,64,341,5.328125
"65",2006-01-01,1,5,-121.4978986,38.62504428,65,346,5.32307692307692
"66",2006-01-01,3,7,-121.4737052,38.56984785,66,353,5.34848484848485
"67",2006-01-01,5,7,-121.4461653,38.46518116,67,360,5.37313432835821
"68",2006-01-01,5,8,-121.4258719,38.4497213,68,368,5.41176470588235
"69",2006-01-01,5,5,-121.427615,38.47143667,69,373,5.40579710144928
"70",2006-01-01,2,7,-121.4152799,38.61972226,70,380,5.42857142857143
"71",2006-01-01,5,4,-121.477826,38.49570962,71,384,5.40845070422535
"72",2006-01-01,2,8,-121.4226958,38.62070956,72,392,5.44444444444444
"73",2006-01-01,1,8,-121.4934272,38.61488957,73,400,5.47945205479452
"74",2006-01-01,3,2,-121.5059336,38.58239328,74,402,5.43243243243243
"75",2006-01-01,6,8,-121.4661214,38.53116122,75,410,5.46666666666667
"76",2006-01-01,2,2,-121.4473501,38.60641085,76,412,5.42105263157895
"77",2006-01-01,3,7,-121.4882896,38.57682477,77,419,5.44155844155844
"78",2006-01-01,1,4,-121.5287747,38.63207451,78,423,5.42307692307692
"79",2006-01-01,2,7,-121.456171,38.60108154,79,430,5.44303797468354
"80",2006-01-01,5,5,-121.4996944,38.47489873,80,435,5.4375
"81",2006-01-01,1,4,-121.5226753,38.67510292,81,439,5.41975308641975
"82",2006-01-01,5,7,-121.4513773,38.46594742,82,446,5.4390243902439
"83",2006-01-01,6,3,-121.409083,38.51055016,83,449,5.40963855421687
"84",2006-01-01,3,7,-121.465448,38.570664,84,456,5.42857142857143
"85",2006-01-01,2,9,-121.4563115,38.6432324,85,465,5.47058823529412
"86",2006-01-01,1,3,-121.5035491,38.67318557,86,468,5.44186046511628
"87",2006-01-01,1,6,-121.5088707,38.66695301,87,474,5.44827586206897
"88",2006-01-01,5,7,-121.443044,38.45025842,88,481,5.46590909090909
"89",2006-01-01,6,7,-121.4378491,38.52337984,89,488,5.48314606741573
"90",2006-01-01,4,3,-121.4923822,38.56159185,90,491,5.45555555555556
"91",2006-01-01,3,4,-121.4516767,38.56438552,91,495,5.43956043956044
"92",2006-01-01,5,1,-121.4619674,38.49603233,92,496,5.39130434782609
"93",2006-01-01,6,5,-121.4469794,38.52967087,93,501,5.38709677419355
"94",2006-01-01,5,5,-121.4368769,38.47425283,94,506,5.38297872340426
"95",2006-01-01,3,3,-121.4864344,38.57941421,95,509,5.35789473684211
"96",2006-01-01,5,1,-121.4368769,38.47425283,96,510,5.3125
"97",2006-01-01,4,4,-121.5136898,38.49714012,97,514,5.29896907216495
"98",2006-01-01,3,2,-121.4692575,38.57201606,98,516,5.26530612244898
"99",2006-01-01,2,5,-121.4382569,38.61859754,99,521,5.26262626262626
"100",2006-01-01,3,5,-121.4678719,38.57348427,100,526,5.26
"101",2006-01-01,2,7,-121.4578062,38.61197962,101,533,5.27722772277228
"102",2006-01-01,1,2,-121.5104473,38.62099831,102,535,5.24509803921569
"103",2006-01-01,6,1,-121.4142712,38.51755951,103,536,5.20388349514563
"104",2006-01-01,2,7,-121.4392401,38.63465784,104,543,5.22115384615385
"105",2006-01-01,2,5,-121.4477394,38.65509277,105,548,5.21904761904762
"106",2006-01-01,4,7,-121.5412748,38.5076709,106,555,5.23584905660377
"107",2006-01-01,2,8,-121.4535351,38.65966202,107,563,5.26168224299065
"108",2006-01-01,2,4,-121.4534714,38.61499077,108,567,5.25
"109",2006-01-01,1,2,-121.5038615,38.65699142,109,569,5.22018348623853
"110",2006-01-01,2,2,-121.4213652,38.63500106,110,571,5.19090909090909
"111",2006-01-01,5,2,-121.4592772,38.49601155,111,573,5.16216216216216
"112",2006-01-01,6,7,-121.4709505,38.54182394,112,580,5.17857142857143
"113",2006-01-01,2,2,-121.4130509,38.63963285,113,582,5.15044247787611
"114",2006-01-01,1,7,-121.5282646,38.63351404,114,589,5.16666666666667
"115",2006-01-01,2,7,-121.4244182,38.61199425,115,596,5.18260869565217
"116",2006-01-01,3,5,-121.4761823,38.57546355,116,601,5.18103448275862
"117",2006-01-01,4,2,-121.5534498,38.50771305,117,603,5.15384615384615
"118",2006-01-01,4,7,-121.5286379,38.51617367,118,610,5.16949152542373
"119",2006-01-01,2,4,-121.4352821,38.60088271,119,614,5.15966386554622
"120",2006-01-01,1,7,-121.4903723,38.63244741,120,621,5.175
"121",2006-01-01,1,7,-121.513946,38.62275946,121,628,5.1900826446281
"122",2006-01-01,4,1,-121.5343434,38.51110856,122,629,5.15573770491803
"123",2006-01-01,2,5,-121.4444547,38.61286644,123,634,5.15447154471545
"124",2006-01-01,1,7,-121.4993798,38.61301252,124,641,5.16935483870968
"125",2006-01-01,1,5,-121.5411045,38.60758365,125,646,5.168
"126",2006-01-01,2,1,-121.4477394,38.65509277,126,647,5.13492063492064
"127",2006-01-01,4,1,-121.515833,38.5206653,127,648,5.10236220472441
"128",2006-01-01,1,2,-121.528707,38.62749128,128,650,5.078125
"129",2006-01-01,3,3,-121.4106138,38.55456463,129,653,5.06201550387597
"130",2006-01-01,1,1,-121.5291389,38.66227019,130,654,5.03076923076923
"131",2006-01-01,3,1,-121.409084,38.5695415,131,655,5
"132",2006-01-01,1,5,-121.5119979,38.65731154,132,660,5
"133",2006-01-01,6,6,-121.4620361,38.54072015,133,666,5.00751879699248
"134",2006-01-01,4,6,-121.5068742,38.53437911,134,672,5.01492537313433
"135",2006-01-01,2,1,-121.431713,38.62194039,135,673,4.98518518518518
"136",2006-01-01,5,4,-121.4161718,38.46337225,136,677,4.97794117647059
"137",2006-01-01,3,6,-121.3882189,38.54929974,137,683,4.98540145985401
"138",2006-01-01,5,7,-121.456788,38.46449565,138,690,5
"139",2006-01-01,3,4,-121.500996,38.58259727,139,694,4.99280575539568
"140",2006-01-01,6,7,-121.4458147,38.54100057,140,701,5.00714285714286
"141",2006-01-01,6,2,-121.4477561,38.53725889,141,703,4.98581560283688
"142",2006-01-01,4,1,-121.5139339,38.52545723,142,704,4.95774647887324
"143",2006-01-01,2,8,-121.454378,38.61361383,143,712,4.97902097902098
"144",2006-01-01,3,1,-121.5014996,38.58062786,144,713,4.95138888888889
"145",2006-01-01,5,6,-121.5001978,38.48682651,145,719,4.95862068965517
"146",2006-01-01,3,2,-121.4974538,38.58137649,146,721,4.93835616438356
"147",2006-01-01,5,6,-121.4360926,38.48023792,147,727,4.94557823129252
"148",2006-01-01,3,5,-121.4858505,38.58472227,148,732,4.94594594594595
"149",2006-01-01,2,3,-121.422421,38.60666541,149,735,4.93288590604027
"150",2006-01-01,2,6,-121.3815598,38.63862878,150,741,4.94
"151",2006-01-01,5,5,-121.448306,38.48420982,151,746,4.94039735099338
"152",2006-01-01,3,8,-121.3902704,38.56047289,152,754,4.96052631578947
"153",2006-01-01,2,7,-121.462463,38.65394829,153,761,4.97385620915033
"154",2006-01-01,2,2,-121.4447319,38.62221222,154,763,4.95454545454545
"155",2006-01-01,2,7,-121.4304825,38.62524321,155,770,4.96774193548387
"156",2006-01-01,5,2,-121.4304773,38.46027205,156,772,4.94871794871795
"157",2006-01-01,2,7,-121.4244182,38.61199425,157,779,4.96178343949045
"158",2006-01-01,2,3,-121.42747,38.60154457,158,782,4.94936708860759
"159",2006-01-01,2,1,-121.4424469,38.61317258,159,783,4.92452830188679
"160",2006-01-01,4,6,-121.4990149,38.52199137,160,789,4.93125
"161",2006-01-01,2,2,-121.440864,38.63070055,161,791,4.91304347826087
"162",2006-01-01,2,7,-121.3846125,38.6374478,162,798,4.92592592592593
"163",2006-01-01,3,7,-121.4313525,38.56839814,163,805,4.93865030674847
"164",2006-01-01,5,5,-121.5015786,38.48020103,164,810,4.9390243902439
"165",2006-01-01,1,9,-121.528,38.63910642,165,819,4.96363636363636
"166",2006-01-01,3,8,-121.5029735,38.57543889,166,827,4.98192771084337
"167",2006-01-01,5,5,-121.4613302,38.49203951,167,832,4.98203592814371
"168",2006-01-01,1,7,-121.5345401,38.6776884,168,839,4.99404761904762
"169",2006-01-01,6,8,-121.4712254,38.54199544,169,847,5.01183431952663
"170",2006-01-01,4,5,-121.5313723,38.5127908,170,852,5.01176470588235
"171",2006-01-01,3,1,-121.4852542,38.56796664,171,853,4.98830409356725
"172",2006-01-01,4,2,-121.4804148,38.50488174,172,855,4.97093023255814
"173",2006-01-01,4,3,-121.4990149,38.52199137,173,858,4.95953757225434
"174",2006-01-01,2,1,-121.4261249,38.64823548,174,859,4.9367816091954
"175",2006-01-01,1,4,-121.5055312,38.63589608,175,863,4.93142857142857
"176",2006-01-01,2,6,-121.4424398,38.63869884,176,869,4.9375
"177",2006-01-01,1,7,-121.4969793,38.66157492,177,876,4.94915254237288
"178",2006-01-01,5,4,-121.4296995,38.47415723,178,880,4.9438202247191
"179",2006-01-01,3,4,-121.3940644,38.54818818,179,884,4.93854748603352
"180",2006-01-01,3,4,-121.3751255,38.5530906,180,888,4.93333333333333
"181",2006-01-01,2,1,-121.4242104,38.64770425,181,889,4.91160220994475
"182",2006-01-01,3,3,-121.4786515,38.56737967,182,892,4.9010989010989
"183",2006-01-01,1,5,-121.4953467,38.60972461,183,897,4.9016393442623
"184",2006-01-01,5,2,-121.4133413,38.45718227,184,899,4.88586956521739
"185",2006-01-01,3,3,-121.4838823,38.5777553,185,902,4.87567567567568
"186",2006-01-01,5,5,-121.4291448,38.45964489,186,907,4.87634408602151
"187",2006-01-01,6,5,-121.4129728,38.50926564,187,912,4.87700534759358
"188",2006-01-01,2,7,-121.4281542,38.63535055,188,919,4.88829787234043
"189",2006-01-01,1,2,-121.487454,38.62642643,189,921,4.87301587301587
"190",2006-01-01,3,7,-121.4902264,38.58432423,190,928,4.88421052631579
"191",2006-01-01,3,3,-121.4872296,38.57001564,191,931,4.87434554973822
"192",2006-01-01,6,8,-121.4438874,38.52496323,192,939,4.890625
"193",2006-01-01,6,5,-121.4443121,38.52517945,193,944,4.89119170984456
"194",2006-01-01,2,7,-121.4590851,38.62009985,194,951,4.9020618556701
"195",2006-01-01,2,6,-121.4204494,38.6176064,195,957,4.90769230769231
"196",2006-01-01,6,5,-121.4728119,38.54069286,196,962,4.90816326530612
"197",2006-01-01,4,4,-121.4913716,38.56108765,197,966,4.90355329949239
"198",2006-01-01,2,3,-121.4258496,38.62764502,198,969,4.89393939393939
"199",2006-01-01,6,1,-121.4443121,38.52517945,199,970,4.87437185929648
"200",2006-01-01,1,1,-121.5223763,38.65543537,200,971,4.855
"201",2006-01-01,5,7,-121.4579445,38.49250972,201,978,4.86567164179105
"202",2006-01-01,3,9,-121.4940223,38.60057486,202,987,4.88613861386139
"203",2006-01-01,2,6,-121.4587997,38.61712192,203,993,4.89162561576355
"204",2006-01-01,2,6,-121.4587997,38.61712192,204,999,4.89705882352941
"205",2006-01-01,5,5,-121.4127165,38.44227407,205,1004,4.89756097560976
"206",2006-01-01,2,7,-121.4177759,38.63425266,206,1011,4.90776699029126
"207",2006-01-01,4,4,-121.4762723,38.55701398,207,1015,4.90338164251208
"208",2006-01-01,3,2,-121.4848464,38.58376222,208,1017,4.88942307692308
"209",2006-01-01,6,7,-121.4674602,38.54242302,209,1024,4.89952153110048
"210",2006-01-01,3,4,-121.5050785,38.59572389,210,1028,4.8952380952381
"211",2006-01-01,2,5,-121.46479,38.609884,211,1033,4.8957345971564
"212",2006-01-01,1,7,-121.5092581,38.62798992,212,1040,4.90566037735849
"213",2006-01-01,2,7,-121.4295032,38.60240036,213,1047,4.91549295774648
"214",2006-01-01,3,1,-121.4924504,38.57117547,214,1048,4.89719626168224
"215",2006-01-01,6,7,-121.4112131,38.50482198,215,1055,4.90697674418605
"216",2006-01-01,1,4,-121.494681,38.61328867,216,1059,4.90277777777778
"217",2006-01-01,2,1,-121.4593596,38.61112465,217,1060,4.88479262672811
"218",2006-01-01,1,4,-121.4971301,38.62581805,218,1064,4.88073394495413
"219",2006-01-01,1,5,-121.5119472,38.61102318,219,1069,4.88127853881279
"220",2006-01-01,2,6,-121.4260893,38.62266231,220,1075,4.88636363636364
"221",2006-01-01,3,8,-121.4792459,38.56788759,221,1083,4.90045248868778
"222",2006-01-01,1,5,-121.4763493,38.63659439,222,1088,4.9009009009009
"223",2006-01-01,6,6,-121.4434066,38.52654807,223,1094,4.90582959641256
"224",2006-01-01,5,8,-121.4592772,38.49601155,224,1102,4.91964285714286
"225",2006-01-01,2,5,-121.4269745,38.60311006,225,1107,4.92
"226",2006-01-01,1,5,-121.4924786,38.61589867,226,1112,4.92035398230088
"227",2006-01-01,2,2,-121.4528434,38.60880668,227,1114,4.90748898678414
"228",2006-01-01,6,5,-121.4506403,38.53137433,228,1119,4.90789473684211
"229",2006-01-01,6,5,-121.4523742,38.5313798,229,1124,4.90829694323144
"230",2006-01-01,3,7,-121.3880115,38.56165546,230,1131,4.91739130434783
"231",2006-01-01,1,7,-121.4745819,38.64316291,231,1138,4.92640692640693
"232",2006-01-01,6,4,-121.4114993,38.52225475,232,1142,4.92241379310345
"233",2006-01-01,2,7,-121.4507882,38.64390931,233,1149,4.931330472103
"234",2006-01-01,6,3,-121.3675001,38.51585237,234,1152,4.92307692307692
"235",2006-01-01,6,5,-121.4505653,38.54020494,235,1157,4.92340425531915
"236",2006-01-01,5,2,-121.4336162,38.47226256,236,1159,4.91101694915254
"237",2006-01-01,2,5,-121.4538176,38.66757714,237,1164,4.91139240506329
"238",2006-01-01,3,8,-121.5036468,38.5842425,238,1172,4.92436974789916
"239",2006-01-01,3,7,-121.4758978,38.57562427,239,1179,4.93305439330544
"240",2006-01-01,1,4,-121.5088422,38.67667622,240,1183,4.92916666666667
"241",2006-01-01,2,2,-121.4226379,38.60667473,241,1185,4.91701244813278
"242",2006-01-01,3,4,-121.5069731,38.57016732,242,1189,4.91322314049587
"243",2006-01-01,2,5,-121.4300065,38.61472939,243,1194,4.91358024691358
"244",2006-01-01,1,8,-121.4755343,38.61935446,244,1202,4.92622950819672
"245",2006-01-01,2,5,-121.4415704,38.61292672,245,1207,4.9265306122449
"246",2006-01-01,5,5,-121.4284026,38.46292264,246,1212,4.92682926829268
"247",2006-01-01,5,1,-121.4312631,38.46377975,247,1213,4.91093117408907
"248",2006-01-01,6,4,-121.4684533,38.5550754,248,1217,4.90725806451613
"249",2006-01-01,3,7,-121.4877874,38.58245172,249,1224,4.91566265060241
"250",2006-01-01,3,7,-121.4289124,38.55645223,250,1231,4.924
"251",2006-01-02,6,5,-121.4490342,38.54470924,251,1236,4.92430278884462
"252",2006-01-02,5,6,-121.4603514,38.4625133,252,1242,4.92857142857143
"253",2006-01-02,1,7,-121.5190467,38.67660642,253,1249,4.93675889328063
"254",2006-01-02,4,5,-121.5477443,38.50751789,254,1254,4.93700787401575
"255",2006-01-02,3,4,-121.4763254,38.56502139,255,1258,4.93333333333333
"256",2006-01-02,6,4,-121.4243203,38.54783739,256,1262,4.9296875
"257",2006-01-02,3,4,-121.4061503,38.55137298,257,1266,4.92607003891051
"258",2006-01-02,1,7,-121.5192803,38.60824476,258,1273,4.93410852713178
"259",2006-01-02,6,4,-121.4591392,38.54468278,259,1277,4.93050193050193
"260",2006-01-02,6,7,-121.459316,38.54118802,260,1284,4.93846153846154
"261",2006-01-02,2,2,-121.4634451,38.62769343,261,1286,4.9272030651341
"262",2006-01-02,5,7,-121.5002604,38.47687825,262,1293,4.93511450381679
"263",2006-01-02,5,3,-121.4584554,38.48227523,263,1296,4.9277566539924
"264",2006-01-02,2,7,-121.451289,38.66254563,264,1303,4.93560606060606
"265",2006-01-02,4,6,-121.5249979,38.51484622,265,1309,4.93962264150943
"266",2006-01-02,1,6,-121.5056249,38.62743901,266,1315,4.94360902255639
"267",2006-01-02,5,1,-121.4803303,38.47663386,267,1316,4.92883895131086
"268",2006-01-02,5,3,-121.4180465,38.44973707,268,1319,4.92164179104478
"269",2006-01-02,1,3,-121.4796125,38.61880719,269,1322,4.91449814126394
"270",2006-01-02,5,5,-121.4078016,38.44803746,270,1327,4.91481481481481
"271",2006-01-02,4,7,-121.5419071,38.51042757,271,1334,4.92250922509225
"272",2006-01-02,4,7,-121.514852,38.48243228,272,1341,4.93014705882353
"273",2006-01-02,6,4,-121.4684935,38.55155803,273,1345,4.92673992673993
"274",2006-01-02,3,1,-121.48322,38.58612197,274,1346,4.91240875912409
"275",2006-01-02,2,1,-121.4306804,38.60879322,275,1347,4.89818181818182
"276",2006-01-02,3,7,-121.4814732,38.59444259,276,1354,4.90579710144928
"277",2006-01-02,4,5,-121.515322,38.48369463,277,1359,4.90613718411552
"278",2006-01-02,6,7,-121.4573325,38.5454679,278,1366,4.9136690647482
"279",2006-01-02,2,2,-121.4321298,38.64036498,279,1368,4.90322580645161
"280",2006-01-02,3,5,-121.4692575,38.57201606,280,1373,4.90357142857143
"281",2006-01-02,4,6,-121.4792852,38.55531685,281,1379,4.90747330960854
"282",2006-01-02,2,4,-121.4446434,38.6358152,282,1383,4.90425531914894
"283",2006-01-02,2,3,-121.4200242,38.59156169,283,1386,4.89752650176678
"284",2006-01-02,6,5,-121.4079133,38.53444222,284,1391,4.89788732394366
"285",2006-01-02,3,2,-121.493943,38.57920289,285,1393,4.88771929824561
"286",2006-01-02,6,1,-121.4230827,38.54867149,286,1394,4.87412587412587
"287",2006-01-02,2,5,-121.4416684,38.63482334,287,1399,4.87456445993031
"288",2006-01-02,2,6,-121.4618489,38.62073056,288,1405,4.87847222222222
"289",2006-01-02,1,2,-121.4770641,38.60930026,289,1407,4.86851211072664
"290",2006-01-02,1,7,-121.4756162,38.62630755,290,1414,4.87586206896552
"291",2006-01-02,2,6,-121.4572951,38.62073678,291,1420,4.87972508591065
"292",2006-01-02,2,4,-121.4234494,38.61538617,292,1424,4.87671232876712
"293",2006-01-02,6,6,-121.4211919,38.51364018,293,1430,4.88054607508532
"294",2006-01-02,2,8,-121.4631893,38.62866431,294,1438,4.89115646258503
"295",2006-01-02,5,5,-121.4585038,38.46252937,295,1443,4.89152542372881
"296",2006-01-02,2,3,-121.446116,38.62968232,296,1446,4.88513513513514
"297",2006-01-02,3,4,-121.4854381,38.58514056,297,1450,4.88215488215488
"298",2006-01-02,3,5,-121.4319262,38.57630105,298,1455,4.88255033557047
"299",2006-01-02,2,6,-121.4516527,38.60527526,299,1461,4.88628762541806
"300",2006-01-02,3,5,-121.4742082,38.57848338,300,1466,4.88666666666667
"301",2006-01-02,6,5,-121.4657714,38.54102578,301,1471,4.88704318936877
"302",2006-01-02,4,2,-121.532542,38.51348202,302,1473,4.87748344370861
"303",2006-01-02,3,1,-121.491401,38.56382548,303,1474,4.86468646864686
"304",2006-01-02,2,5,-121.4205954,38.60739495,304,1479,4.86513157894737
"305",2006-01-02,3,5,-121.5068273,38.57962095,305,1484,4.8655737704918
"306",2006-01-02,1,7,-121.4935886,38.6089261,306,1491,4.87254901960784
"307",2006-01-02,2,7,-121.4642874,38.62275189,307,1498,4.87947882736156
"308",2006-01-02,1,7,-121.5096441,38.65941872,308,1505,4.88636363636364
"309",2006-01-02,3,4,-121.4839757,38.59530776,309,1509,4.88349514563107
"310",2006-01-02,5,5,-121.4398174,38.47433302,310,1514,4.88387096774194
"311",2006-01-02,5,5,-121.4183343,38.43840598,311,1519,4.88424437299035
"312",2006-01-02,6,8,-121.4558291,38.54454369,312,1527,4.89423076923077
"313",2006-01-02,2,7,-121.4382598,38.59645425,313,1534,4.90095846645367
"314",2006-01-02,6,4,-121.4474575,38.54061027,314,1538,4.89808917197452
"315",2006-01-02,6,4,-121.4095726,38.51007761,315,1542,4.8952380952381
"316",2006-01-02,2,7,-121.4252477,38.60027317,316,1549,4.90189873417722
"317",2006-01-02,2,7,-121.4275537,38.59808509,317,1556,4.90851735015773
"318",2006-01-02,3,3,-121.4839757,38.59530776,318,1559,4.90251572327044
"319",2006-01-02,3,5,-121.4267606,38.55614777,319,1564,4.90282131661442
"320",2006-01-02,2,5,-121.4303283,38.63228581,320,1569,4.903125
"321",2006-01-02,5,5,-121.4180465,38.44973707,321,1574,4.90342679127726
"322",2006-01-02,2,5,-121.423349,38.59664183,322,1579,4.90372670807453
"323",2006-01-02,2,7,-121.4295789,38.63931448,323,1586,4.91021671826625
"324",2006-01-02,6,5,-121.4456482,38.52823386,324,1591,4.91049382716049
"325",2006-01-02,5,2,-121.5014051,38.47602372,325,1593,4.90153846153846
"326",2006-01-02,5,4,-121.4420784,38.45541339,326,1597,4.89877300613497
"327",2006-01-02,3,5,-121.5036968,38.58057689,327,1602,4.89908256880734
"328",2006-01-02,3,5,-121.4907608,38.57218405,328,1607,4.89939024390244
"329",2006-01-02,5,1,-121.4799768,38.49543922,329,1608,4.88753799392097
"330",2006-01-02,3,7,-121.4854271,38.57163324,330,1615,4.89393939393939
"331",2006-01-02,4,1,-121.504668,38.52736754,331,1616,4.8821752265861
"332",2006-01-02,4,7,-121.5084967,38.52062063,332,1623,4.88855421686747
"333",2006-01-02,2,1,-121.4392039,38.62635393,333,1624,4.87687687687688
"334",2006-01-02,3,5,-121.4747123,38.57320247,334,1629,4.87724550898204
"335",2006-01-02,3,6,-121.4827193,38.57411723,335,1635,4.88059701492537
"336",2006-01-02,1,5,-121.4925571,38.61421301,336,1640,4.88095238095238
"337",2006-01-02,2,4,-121.4604896,38.63939388,337,1644,4.87833827893175
"338",2006-01-02,3,7,-121.4806992,38.57725503,338,1651,4.88461538461539
"339",2006-01-02,2,1,-121.4593506,38.61692679,339,1652,4.87315634218289
"340",2006-01-02,3,7,-121.4642683,38.57218529,340,1659,4.87941176470588
"341",2006-01-02,3,4,-121.5052755,38.58245363,341,1663,4.87683284457478
"342",2006-01-02,4,4,-121.4959218,38.53284086,342,1667,4.87426900584795
"343",2006-01-02,6,2,-121.4468745,38.53553572,343,1669,4.86588921282799
"344",2006-01-02,4,5,-121.4923822,38.56159185,344,1674,4.86627906976744
"345",2006-01-02,3,8,-121.4856804,38.57240323,345,1682,4.87536231884058
"346",2006-01-02,1,2,-121.4755625,38.61124309,346,1684,4.86705202312139
"347",2006-01-02,4,5,-121.47576,38.54106323,347,1689,4.86743515850144
"348",2006-01-02,2,5,-121.4590542,38.60986284,348,1694,4.86781609195402
"349",2006-01-02,6,7,-121.4443687,38.542611,349,1701,4.87392550143267
"350",2006-01-02,3,7,-121.4986248,38.58052209,350,1708,4.88
"351",2006-01-02,5,3,-121.4891676,38.47764806,351,1711,4.87464387464387
"352",2006-01-02,1,4,-121.5102676,38.65735092,352,1715,4.87215909090909
"353",2006-01-02,2,3,-121.3815598,38.63862878,353,1718,4.86685552407932
"354",2006-01-02,2,1,-121.4461582,38.62198839,354,1719,4.85593220338983
"355",2006-01-02,2,6,-121.3815598,38.63862878,355,1725,4.85915492957746
"356",2006-01-02,2,7,-121.438211,38.62219451,356,1732,4.86516853932584
"357",2006-01-02,3,3,-121.4091389,38.54940296,357,1735,4.85994397759104
"358",2006-01-02,1,7,-121.4780296,38.63040165,358,1742,4.8659217877095
"359",2006-01-02,6,3,-121.4314836,38.51332326,359,1745,4.86072423398329
"360",2006-01-02,1,5,-121.5085108,38.62875561,360,1750,4.86111111111111
"361",2006-01-02,3,5,-121.5011657,38.58184562,361,1755,4.86149584487535
"362",2006-01-02,4,1,-121.4787921,38.51030591,362,1756,4.85082872928177
"363",2006-01-02,2,4,-121.4414625,38.62982199,363,1760,4.84848484848485
"364",2006-01-02,3,3,-121.4978345,38.57997771,364,1763,4.84340659340659
"365",2006-01-02,2,6,-121.4600156,38.65899218,365,1769,4.84657534246575
"366",2006-01-02,1,7,-121.5085026,38.65023973,366,1776,4.85245901639344
"367",2006-01-02,6,5,-121.4223993,38.53114891,367,1781,4.85286103542234
"368",2006-01-02,4,4,-121.475971,38.51852,368,1785,4.85054347826087
"369",2006-01-02,5,5,-121.437086,38.45790447,369,1790,4.85094850948509
"370",2006-01-02,1,7,-121.4977777,38.67549475,370,1797,4.85675675675676
"371",2006-01-02,5,7,-121.4250682,38.47322263,371,1804,4.86253369272237
"372",2006-01-02,6,7,-121.4199387,38.52507079,372,1811,4.86827956989247
"373",2006-01-02,2,7,-121.4257122,38.63253761,373,1818,4.87399463806971
"374",2006-01-02,2,5,-121.4140661,38.64688728,374,1823,4.87433155080214
"375",2006-01-02,4,5,-121.5071286,38.49297696,375,1828,4.87466666666667
"376",2006-01-02,5,3,-121.4638793,38.47920034,376,1831,4.86968085106383
"377",2006-01-02,3,3,-121.4970836,38.57881567,377,1834,4.86472148541114
"378",2006-01-02,1,7,-121.4926144,38.61402379,378,1841,4.87037037037037
"379",2006-01-02,4,7,-121.4742273,38.49852712,379,1848,4.87598944591029
"380",2006-01-02,3,8,-121.4906312,38.58053662,380,1856,4.88421052631579
"381",2006-01-02,2,5,-121.423449,38.61499899,381,1861,4.88451443569554
"382",2006-01-02,3,5,-121.4841033,38.5704109,382,1866,4.8848167539267
"383",2006-01-02,3,8,-121.4812324,38.57704873,383,1874,4.89295039164491
"384",2006-01-02,5,3,-121.4790012,38.48308908,384,1877,4.88802083333333
"385",2006-01-02,1,3,-121.510595,38.61733037,385,1880,4.88311688311688
"386",2006-01-02,1,5,-121.4755302,38.62753184,386,1885,4.88341968911917
"387",2006-01-02,1,7,-121.5095127,38.65357208,387,1892,4.88888888888889
"388",2006-01-02,1,4,-121.4700175,38.6208506,388,1896,4.88659793814433
"389",2006-01-02,3,2,-121.4885101,38.56363425,389,1898,4.87917737789203
"390",2006-01-02,2,5,-121.4489382,38.62053806,390,1903,4.87948717948718
"391",2006-01-02,2,2,-121.4504831,38.60765045,391,1905,4.87212276214834
"392",2006-01-02,3,6,-121.489911,38.57900945,392,1911,4.875
"393",2006-01-02,1,7,-121.4755286,38.6296517,393,1918,4.88040712468193
"394",2006-01-02,5,7,-121.4443013,38.4735803,394,1925,4.88578680203046
"395",2006-01-02,2,3,-121.4618026,38.61110308,395,1928,4.88101265822785
"396",2006-01-03,2,8,-121.4558592,38.66166376,396,1936,4.88888888888889
"397",2006-01-03,1,7,-121.5129034,38.64420903,397,1943,4.89420654911839
"398",2006-01-03,6,7,-121.4614493,38.54944953,398,1950,4.89949748743719
"399",2006-01-03,6,5,-121.41042,38.50098733,399,1955,4.89974937343358
"400",2006-01-03,2,7,-121.4560212,38.62255411,400,1962,4.905
"401",2006-01-03,3,4,-121.5075511,38.57308322,401,1966,4.90274314214464
"402",2006-01-03,3,4,-121.5075511,38.57308322,402,1970,4.90049751243781
"403",2006-01-03,3,4,-121.5075511,38.57308322,403,1974,4.89826302729529
"404",2006-01-03,4,7,-121.5116968,38.52186986,404,1981,4.90346534653465
"405",2006-01-03,1,7,-121.4947194,38.61775373,405,1988,4.90864197530864
"406",2006-01-03,2,4,-121.4625907,38.65467106,406,1992,4.9064039408867
"407",2006-01-03,5,7,-121.5030125,38.49502703,407,1999,4.91154791154791
"408",2006-01-03,2,5,-121.4481266,38.61867245,408,2004,4.91176470588235
"409",2006-01-03,5,1,-121.414127,38.46101961,409,2005,4.90220048899756
"410",2006-01-03,4,7,-121.5356226,38.48531018,410,2012,4.90731707317073
"411",2006-01-03,2,7,-121.4216859,38.64336682,411,2019,4.91240875912409
"412",2006-01-03,3,5,-121.5056982,38.59667389,412,2024,4.9126213592233
"413",2006-01-03,6,7,-121.4728661,38.55513128,413,2031,4.91767554479419
"414",2006-01-03,6,5,-121.4487903,38.52512948,414,2036,4.91787439613527
"415",2006-01-03,3,5,-121.4826732,38.57372161,415,2041,4.91807228915663
"416",2006-01-03,4,2,-121.4819248,38.50290045,416,2043,4.91105769230769
"417",2006-01-03,1,6,-121.527605,38.66172026,417,2049,4.9136690647482
"418",2006-01-03,3,5,-121.4715453,38.58048952,418,2054,4.91387559808612
"419",2006-01-03,3,7,-121.4985749,38.60055347,419,2061,4.91885441527446
"420",2006-01-03,3,7,-121.4116414,38.55463027,420,2068,4.92380952380952
"421",2006-01-03,3,2,-121.4773354,38.5722972,421,2070,4.91686460807601
"422",2006-01-03,2,7,-121.4618713,38.65300918,422,2077,4.9218009478673
"423",2006-01-03,4,5,-121.5128857,38.52845688,423,2082,4.92198581560284
"424",2006-01-03,5,4,-121.5024485,38.48972495,424,2086,4.91981132075472
"425",2006-01-03,3,7,-121.4976906,38.57905171,425,2093,4.92470588235294
"426",2006-01-03,4,5,-121.5269234,38.51382164,426,2098,4.92488262910798
"427",2006-01-03,2,5,-121.4423353,38.63684482,427,2103,4.92505854800937
"428",2006-01-03,1,4,-121.5015993,38.68251335,428,2107,4.92289719626168
"429",2006-01-03,2,4,-121.4445924,38.61586018,429,2111,4.92074592074592
"430",2006-01-03,4,8,-121.4978746,38.53402736,430,2119,4.92790697674419
"431",2006-01-03,4,6,-121.4978746,38.53402736,431,2125,4.93039443155452
"432",2006-01-03,4,6,-121.488409,38.53432365,432,2131,4.93287037037037
"433",2006-01-03,2,5,-121.4042501,38.63908268,433,2136,4.93302540415704
"434",2006-01-03,3,3,-121.4669044,38.57984491,434,2139,4.92857142857143
"435",2006-01-03,2,7,-121.4622882,38.63535473,435,2146,4.93333333333333
"436",2006-01-03,1,6,-121.500334,38.63365507,436,2152,4.93577981651376
"437",2006-01-03,6,4,-121.3889165,38.51928736,437,2156,4.93363844393593
"438",2006-01-03,4,1,-121.4867588,38.56010621,438,2157,4.92465753424658
"439",2006-01-03,6,7,-121.4212258,38.5404985,439,2164,4.92938496583144
"440",2006-01-03,6,4,-121.4673115,38.54219716,440,2168,4.92727272727273
"441",2006-01-03,6,5,-121.4335978,38.53494151,441,2173,4.92743764172336
"442",2006-01-03,6,5,-121.4139778,38.53243835,442,2178,4.92760180995475
"443",2006-01-03,4,3,-121.4712477,38.52718667,443,2181,4.92325056433409
"444",2006-01-03,1,7,-121.5279374,38.62688953,444,2188,4.92792792792793
"445",2006-01-03,3,5,-121.4926811,38.5923559,445,2193,4.92808988764045
"446",2006-01-03,2,7,-121.4244182,38.61199425,446,2200,4.93273542600897
"447",2006-01-03,4,7,-121.5075131,38.49397262,447,2207,4.93736017897092
"448",2006-01-03,1,5,-121.49973,38.62145778,448,2212,4.9375
"449",2006-01-03,2,5,-121.4404159,38.60929375,449,2217,4.93763919821826
"450",2006-01-03,3,1,-121.493943,38.57920289,450,2218,4.92888888888889
"451",2006-01-03,3,5,-121.4681757,38.57965854,451,2223,4.9290465631929
"452",2006-01-03,5,1,-121.4506994,38.48235122,452,2224,4.92035398230088
"453",2006-01-03,4,5,-121.5231254,38.47704073,453,2229,4.9205298013245
"454",2006-01-03,1,3,-121.5047204,38.62612259,454,2232,4.91629955947137
"455",2006-01-03,5,1,-121.440072,38.4797218,455,2233,4.90769230769231
"456",2006-01-03,3,1,-121.4878834,38.57882476,456,2234,4.89912280701754
"457",2006-01-03,6,5,-121.3965716,38.51839666,457,2239,4.89934354485777
"458",2006-01-03,1,5,-121.5363804,38.67803627,458,2244,4.89956331877729
"459",2006-01-03,1,4,-121.5363135,38.65333642,459,2248,4.89760348583878
"460",2006-01-03,4,5,-121.5235386,38.49417981,460,2253,4.89782608695652
"461",2006-01-03,2,5,-121.4042501,38.63908268,461,2258,4.89804772234273
"462",2006-01-03,3,1,-121.5000936,38.58207989,462,2259,4.88961038961039
"463",2006-01-03,4,5,-121.5205386,38.51896869,463,2264,4.88984881209503
"464",2006-01-03,2,5,-121.4252477,38.60027317,464,2269,4.89008620689655
"465",2006-01-03,6,5,-121.4703011,38.54264475,465,2274,4.89032258064516
"466",2006-01-03,6,4,-121.4105872,38.53069117,466,2278,4.88841201716738
"467",2006-01-03,2,7,-121.4225354,38.616307,467,2285,4.89293361884368
"468",2006-01-03,2,7,-121.4413653,38.63909731,468,2292,4.8974358974359
"469",2006-01-03,6,7,-121.4211919,38.51364018,469,2299,4.90191897654584
"470",2006-01-03,6,2,-121.4443079,38.54368712,470,2301,4.89574468085106
"471",2006-01-03,1,1,-121.4755923,38.60672341,471,2302,4.88747346072187
"472",2006-01-03,1,7,-121.5276476,38.66321971,472,2309,4.89194915254237
"473",2006-01-03,4,3,-121.4757955,38.54242538,473,2312,4.88794926004228
"474",2006-01-03,5,1,-121.4716869,38.4876828,474,2313,4.87974683544304
"475",2006-01-03,3,4,-121.5081215,38.5740577,475,2317,4.87789473684211
"476",2006-01-03,5,8,-121.4749039,38.49442501,476,2325,4.88445378151261
"477",2006-01-03,3,1,-121.4417047,38.56940412,477,2326,4.87631027253669
"478",2006-01-03,3,5,-121.4781317,38.56480438,478,2331,4.8765690376569
"479",2006-01-03,2,5,-121.4529308,38.6161168,479,2336,4.8768267223382
"480",2006-01-03,3,1,-121.4436297,38.56654113,480,2337,4.86875
"481",2006-01-03,3,1,-121.4783232,38.57688189,481,2338,4.86070686070686
"482",2006-01-03,4,6,-121.5391044,38.50336488,482,2344,4.86307053941909
"483",2006-01-03,3,1,-121.4966071,38.57991197,483,2345,4.85507246376812
"484",2006-01-03,5,1,-121.4608538,38.48155327,484,2346,4.84710743801653
"485",2006-01-03,2,9,-121.4529344,38.63252107,485,2355,4.85567010309278
"486",2006-01-03,2,1,-121.4235653,38.61186919,486,2356,4.8477366255144
"487",2006-01-03,6,3,-121.4711438,38.54121247,487,2359,4.84394250513347
"488",2006-01-03,3,1,-121.4262591,38.57024299,488,2360,4.83606557377049
"489",2006-01-03,3,5,-121.3883992,38.54988284,489,2365,4.83640081799591
"490",2006-01-03,2,5,-121.4267572,38.66583461,490,2370,4.83673469387755
"491",2006-01-03,2,5,-121.4530341,38.64006189,491,2375,4.83706720977597
"492",2006-01-03,3,4,-121.4892459,38.58249661,492,2379,4.83536585365854
"493",2006-01-03,3,1,-121.5073808,38.57899998,493,2380,4.82758620689655
"494",2006-01-03,3,1,-121.4828556,38.56641822,494,2381,4.81983805668016
"495",2006-01-03,4,7,-121.5368634,38.51270034,495,2388,4.82424242424242
"496",2006-01-03,5,4,-121.4760448,38.49511942,496,2392,4.82258064516129
"497",2006-01-03,2,1,-121.4300114,38.6377679,497,2393,4.8148893360161
"498",2006-01-03,5,5,-121.458006,38.49362212,498,2398,4.81526104417671
"499",2006-01-03,2,3,-121.4600156,38.65899218,499,2401,4.81162324649299
"500",2006-01-03,1,5,-121.5086433,38.61409015,500,2406,4.812
"501",2006-01-03,2,7,-121.421177,38.61722561,501,2413,4.81636726546906
"502",2006-01-03,1,7,-121.5250742,38.60845539,502,2420,4.8207171314741
"503",2006-01-03,3,1,-121.4962474,38.57734295,503,2421,4.81312127236581
"504",2006-01-03,5,7,-121.4333379,38.4730026,504,2428,4.81746031746032
"505",2006-01-03,5,7,-121.4758183,38.48646868,505,2435,4.82178217821782
"506",2006-01-03,4,5,-121.4936121,38.53563438,506,2440,4.82213438735178
"507",2006-01-03,3,3,-121.4767617,38.57706706,507,2443,4.81854043392505
"508",2006-01-03,2,7,-121.437666,38.62916107,508,2450,4.82283464566929
"509",2006-01-03,3,1,-121.4852913,38.56767025,509,2451,4.81532416502947
"510",2006-01-03,3,5,-121.476897,38.56863488,510,2456,4.8156862745098
"511",2006-01-03,1,7,-121.5179002,38.61619673,511,2463,4.81996086105675
"512",2006-01-03,3,1,-121.479429,38.57777929,512,2464,4.8125
"513",2006-01-03,2,3,-121.4303283,38.63228581,513,2467,4.80896686159844
"514",2006-01-03,5,1,-121.4258719,38.4497213,514,2468,4.80155642023346
"515",2006-01-03,2,6,-121.4303689,38.63070434,515,2474,4.80388349514563
"516",2006-01-03,3,7,-121.506495,38.57759578,516,2481,4.80813953488372
"517",2006-01-03,6,5,-121.466571,38.55378987,517,2486,4.80851063829787
"518",2006-01-03,5,8,-121.4236588,38.44313648,518,2494,4.81467181467182
"519",2006-01-03,3,1,-121.5027369,38.582786,519,2495,4.80732177263969
"520",2006-01-03,6,5,-121.428681,38.53424184,520,2500,4.80769230769231
"521",2006-01-03,6,6,-121.4697342,38.54364991,521,2506,4.80998080614203
"522",2006-01-03,4,7,-121.4882798,38.54844544,522,2513,4.81417624521073
"523",2006-01-03,3,5,-121.483793,38.58138778,523,2518,4.81453154875717
"524",2006-01-03,3,5,-121.3989901,38.5470688,524,2523,4.81488549618321
"525",2006-01-03,5,1,-121.4281961,38.44814292,525,2524,4.80761904761905
"526",2006-01-03,2,3,-121.4336278,38.63778289,526,2527,4.8041825095057
"527",2006-01-03,3,5,-121.4679798,38.56979971,527,2532,4.80455407969639
"528",2006-01-03,2,7,-121.4277652,38.60574184,528,2539,4.80871212121212
"529",2006-01-03,1,2,-121.5030691,38.66064286,529,2541,4.80340264650284
"530",2006-01-03,5,4,-121.4664854,38.4801213,530,2545,4.80188679245283
"531",2006-01-03,2,5,-121.4274874,38.64426884,531,2550,4.80225988700565
"532",2006-01-03,3,5,-121.4838823,38.5777553,532,2555,4.80263157894737
"533",2006-01-03,4,7,-121.535615,38.51495249,533,2562,4.80675422138837
"534",2006-01-03,5,7,-121.4584308,38.48090489,534,2569,4.81086142322097
"535",2006-01-03,4,3,-121.4712477,38.52718667,535,2572,4.80747663551402
"536",2006-01-03,2,6,-121.3815598,38.63862878,536,2578,4.80970149253731
"537",2006-01-03,1,4,-121.5027081,38.64662608,537,2582,4.80819366852886
"538",2006-01-03,4,1,-121.5030091,38.51408657,538,2583,4.80111524163569
"539",2006-01-03,4,5,-121.4792852,38.55531685,539,2588,4.80148423005566
"540",2006-01-03,4,6,-121.479014,38.53881527,540,2594,4.8037037037037
"541",2006-01-03,1,7,-121.5064872,38.62928795,541,2601,4.80776340110906
"542",2006-01-03,5,6,-121.4227089,38.47428454,542,2607,4.809963099631
"543",2006-01-03,1,7,-121.5077758,38.67081464,543,2614,4.81399631675875
"544",2006-01-03,1,3,-121.488539,38.61668041,544,2617,4.81066176470588
"545",2006-01-03,1,6,-121.5064006,38.66809307,545,2623,4.81284403669725
"546",2006-01-03,3,1,-121.4847429,38.579198,546,2624,4.80586080586081
"547",2006-01-03,4,6,-121.5050314,38.55864807,547,2630,4.80804387568556
"548",2006-01-03,3,1,-121.5052755,38.58245363,548,2631,4.80109489051095
"549",2006-01-03,6,7,-121.4347262,38.51737845,549,2638,4.80510018214936
"550",2006-01-03,3,4,-121.4976906,38.57905171,550,2642,4.80363636363636
"551",2006-01-03,6,1,-121.4711438,38.54121247,551,2643,4.7967332123412
"552",2006-01-03,1,6,-121.5055446,38.62942123,552,2649,4.79891304347826
"553",2006-01-03,4,7,-121.4717471,38.52488785,553,2656,4.80289330922242
"554",2006-01-03,2,6,-121.4424398,38.63869884,554,2662,4.80505415162455
"555",2006-01-03,3,1,-121.4830358,38.57629892,555,2663,4.7981981981982
"556",2006-01-03,2,4,-121.4354096,38.62675838,556,2667,4.79676258992806
"557",2006-01-03,5,1,-121.4972996,38.47717845,557,2668,4.78994614003591
"558",2006-01-03,3,5,-121.4955782,38.56858874,558,2673,4.79032258064516
"559",2006-01-03,3,2,-121.4807627,38.57813402,559,2675,4.78533094812165
"560",2006-01-03,5,3,-121.4839042,38.47753956,560,2678,4.78214285714286
"561",2006-01-03,3,5,-121.3908868,38.54439581,561,2683,4.7825311942959
"562",2006-01-03,3,2,-121.4856685,38.59007055,562,2685,4.77758007117438
"563",2006-01-03,1,1,-121.4727959,38.62995233,563,2686,4.7708703374778
"564",2006-01-03,2,1,-121.4495692,38.63446573,564,2687,4.76418439716312
"565",2006-01-03,3,4,-121.4946409,38.57845904,565,2691,4.76283185840708
"566",2006-01-03,5,7,-121.4346919,38.47889655,566,2698,4.76678445229682
"567",2006-01-03,2,3,-121.4626763,38.60894608,567,2701,4.7636684303351
"568",2006-01-03,4,3,-121.5423299,38.51206582,568,2704,4.76056338028169
"569",2006-01-03,2,5,-121.4618136,38.60918097,569,2709,4.7609841827768
"570",2006-01-03,5,5,-121.4923996,38.48540584,570,2714,4.76140350877193
"571",2006-01-03,5,7,-121.4634092,38.49109084,571,2721,4.76532399299475
"572",2006-01-03,2,7,-121.4326769,38.60858334,572,2728,4.76923076923077
"573",2006-01-03,4,4,-121.5379108,38.50422234,573,2732,4.76788830715532
"574",2006-01-03,6,4,-121.458959,38.5467716,574,2736,4.76655052264808
"575",2006-01-03,5,3,-121.4673944,38.49407763,575,2739,4.76347826086957
"576",2006-01-03,5,3,-121.4673944,38.49407763,576,2742,4.76041666666667
"577",2006-01-03,5,7,-121.4568798,38.48642245,577,2749,4.76429809358752
"578",2006-01-03,3,1,-121.4812549,38.5898202,578,2750,4.75778546712803
"579",2006-01-03,2,5,-121.4343762,38.61141174,579,2755,4.75820379965458
"580",2006-01-03,2,5,-121.4343762,38.61141174,580,2760,4.75862068965517
"581",2006-01-03,5,7,-121.4654193,38.48160193,581,2767,4.76247848537005
"582",2006-01-03,6,7,-121.4084943,38.5259245,582,2774,4.76632302405498
"583",2006-01-03,2,4,-121.4276508,38.59994183,583,2778,4.76500857632933
"584",2006-01-03,1,4,-121.4984478,38.6270814,584,2782,4.76369863013699
"585",2006-01-03,3,1,-121.4869021,38.57421273,585,2783,4.75726495726496
"586",2006-01-03,5,9,-121.4549413,38.4831539,586,2792,4.76450511945392
"587",2006-01-03,3,7,-121.49847,38.56970242,587,2799,4.76831345826235
"588",2006-01-03,3,7,-121.49847,38.56970242,588,2806,4.77210884353742
"589",2006-01-03,5,4,-121.4190329,38.43922779,589,2810,4.77079796264856
"590",2006-01-03,4,4,-121.4795627,38.49904003,590,2814,4.76949152542373
"591",2006-01-03,3,4,-121.4622017,38.58138835,591,2818,4.76818950930626
"592",2006-01-03,2,5,-121.4262914,38.61319803,592,2823,4.76858108108108
"593",2006-01-03,6,7,-121.4307286,38.52298255,593,2830,4.77234401349073
"594",2006-01-03,3,4,-121.4639068,38.57235387,594,2834,4.77104377104377
"595",2006-01-03,5,4,-121.4405755,38.46405311,595,2838,4.76974789915966
"596",2006-01-03,1,7,-121.4886746,38.61582702,596,2845,4.77348993288591
"597",2006-01-03,3,7,-121.4142079,38.55424238,597,2852,4.77721943048576
"598",2006-01-03,2,7,-121.4252477,38.60027317,598,2859,4.7809364548495
"599",2006-01-03,6,5,-121.4575722,38.55441531,599,2864,4.78130217028381
"600",2006-01-03,6,3,-121.4647617,38.53952458,600,2867,4.77833333333333
"601",2006-01-03,5,7,-121.4287891,38.44734129,601,2874,4.78202995008319
"602",2006-01-03,2,7,-121.419831,38.64543073,602,2881,4.78571428571429
"603",2006-01-03,2,6,-121.3815598,38.63862878,603,2887,4.787728026534
"604",2006-01-03,3,1,-121.4979339,38.58026647,604,2888,4.78145695364238
"605",2006-01-03,5,8,-121.4170895,38.46689445,605,2896,4.78677685950413
"606",2006-01-03,3,3,-121.4821859,38.57484527,606,2899,4.78382838283828
"607",2006-01-03,6,6,-121.4452442,38.53613202,607,2905,4.78583196046128
"608",2006-01-03,3,5,-121.4408319,38.57097333,608,2910,4.78618421052632
"609",2006-01-03,2,6,-121.422191,38.60093347,609,2916,4.78817733990148
"610",2006-01-03,5,4,-121.4673944,38.49407763,610,2920,4.78688524590164
"611",2006-01-03,5,7,-121.4806735,38.47987012,611,2927,4.79050736497545
"612",2006-01-03,6,1,-121.4181141,38.50576856,612,2928,4.7843137254902
"613",2006-01-03,2,2,-121.456171,38.60108154,613,2930,4.77977161500816
"614",2006-01-03,2,5,-121.4430593,38.60915546,614,2935,4.78013029315961
"615",2006-01-03,3,5,-121.471708,38.56465716,615,2940,4.78048780487805
"616",2006-01-03,1,7,-121.5080076,38.6626053,616,2947,4.78409090909091
"617",2006-01-03,2,5,-121.4619309,38.6084813,617,2952,4.78444084278768
"618",2006-01-03,1,2,-121.4826112,38.6319462,618,2954,4.77993527508091
"619",2006-01-03,2,5,-121.4570454,38.61216003,619,2959,4.78029079159935
"620",2006-01-03,6,3,-121.4652065,38.5272962,620,2962,4.77741935483871
"621",2006-01-03,5,7,-121.4363617,38.44303164,621,2969,4.78099838969404
"622",2006-01-03,1,5,-121.5399288,38.60376214,622,2974,4.78135048231511
"623",2006-01-03,3,8,-121.4890204,38.56953204,623,2982,4.78651685393258
"624",2006-01-03,5,4,-121.4487485,38.47531506,624,2986,4.78525641025641
"625",2006-01-03,3,8,-121.4782896,38.57717555,625,2994,4.7904
"626",2006-01-03,3,5,-121.4818568,38.56957983,626,2999,4.79073482428115
"627",2006-01-03,4,5,-121.4884492,38.51016505,627,3004,4.79106858054227
"628",2006-01-03,4,7,-121.4794507,38.55850838,628,3011,4.79458598726115
"629",2006-01-03,3,7,-121.4758978,38.57562427,629,3018,4.79809220985692
"630",2006-01-03,5,2,-121.4568798,38.48642245,630,3020,4.79365079365079
"631",2006-01-03,2,5,-121.42747,38.60154457,631,3025,4.79397781299525
"632",2006-01-03,2,5,-121.4323383,38.61111345,632,3030,4.79430379746835
"633",2006-01-03,1,7,-121.5365419,38.67744929,633,3037,4.79778830963665
"634",2006-01-03,5,1,-121.4916281,38.48091284,634,3038,4.79179810725552
"635",2006-01-03,4,1,-121.4768749,38.5501848,635,3039,4.78582677165354
"636",2006-01-03,2,5,-121.4235266,38.61319529,636,3044,4.78616352201258
"637",2006-01-03,4,5,-121.4799575,38.53600493,637,3049,4.78649921507064
"638",2006-01-03,2,5,-121.4226037,38.64244876,638,3054,4.78683385579937
"639",2006-01-03,6,3,-121.4384125,38.5397347,639,3057,4.78403755868545
"640",2006-01-03,5,7,-121.448452,38.47435531,640,3064,4.7875
"641",2006-01-03,6,1,-121.4299421,38.51597101,641,3065,4.78159126365055
"642",2006-01-03,2,3,-121.4226379,38.60667473,642,3068,4.77881619937695
"643",2006-01-03,3,1,-121.4833164,38.58248128,643,3069,4.77293934681182
"644",2006-01-03,6,9,-121.450006,38.53157177,644,3078,4.77950310559006
"645",2006-01-03,4,8,-121.4716718,38.52420377,645,3086,4.78449612403101
"646",2006-01-03,6,4,-121.4724356,38.55612335,646,3090,4.78328173374613
"647",2006-01-03,4,7,-121.5076255,38.53747149,647,3097,4.78670788253478
"648",2006-01-03,6,4,-121.4446609,38.53291921,648,3101,4.78549382716049
"649",2006-01-03,2,3,-121.4378029,38.62689633,649,3104,4.78274268104777
"650",2006-01-03,5,3,-121.4564244,38.48474254,650,3107,4.78
"651",2006-01-03,3,2,-121.4976906,38.57905171,651,3109,4.77572964669739
"652",2006-01-04,5,5,-121.4487485,38.47531506,652,3114,4.7760736196319
"653",2006-01-04,1,7,-121.4947194,38.61775373,653,3121,4.77947932618683
"654",2006-01-04,5,4,-121.430088,38.44865752,654,3125,4.7782874617737
"655",2006-01-04,2,7,-121.4344803,38.59829761,655,3132,4.78167938931298
"656",2006-01-04,4,5,-121.5339089,38.51235896,656,3137,4.78201219512195
"657",2006-01-04,1,5,-121.5080524,38.63582718,657,3142,4.78234398782344
"658",2006-01-04,4,7,-121.5319557,38.51282612,658,3149,4.78571428571429
"659",2006-01-04,1,1,-121.4714109,38.61609551,659,3150,4.77996965098634
"660",2006-01-04,1,5,-121.478346,38.61011609,660,3155,4.78030303030303
"661",2006-01-04,6,4,-121.467488,38.5532147,661,3159,4.77912254160363
"662",2006-01-04,3,7,-121.4901707,38.58378853,662,3166,4.78247734138973
"663",2006-01-04,3,3,-121.4894825,38.56360559,663,3169,4.77978883861237
"664",2006-01-04,2,6,-121.4514665,38.63995013,664,3175,4.7816265060241
"665",2006-01-04,6,7,-121.4444079,38.55239225,665,3182,4.78496240601504
"666",2006-01-04,6,1,-121.4455607,38.53139129,666,3183,4.77927927927928
"667",2006-01-04,2,2,-121.4438493,38.63484756,667,3185,4.77511244377811
"668",2006-01-04,4,8,-121.485233,38.55490411,668,3193,4.77994011976048
"669",2006-01-04,2,5,-121.4199458,38.64723814,669,3198,4.78026905829596
"670",2006-01-04,3,3,-121.4278994,38.55280884,670,3201,4.77761194029851
"671",2006-01-04,3,1,-121.4678719,38.57348427,671,3202,4.77198211624441
"672",2006-01-04,6,7,-121.4149165,38.49980195,672,3209,4.77529761904762
"673",2006-01-04,1,5,-121.5104944,38.62535356,673,3214,4.77563150074294
"674",2006-01-04,2,7,-121.4409047,38.63577799,674,3221,4.77893175074184
"675",2006-01-04,4,9,-121.5219586,38.49324791,675,3230,4.78518518518518
"676",2006-01-04,3,5,-121.4792272,38.57428281,676,3235,4.78550295857988
"677",2006-01-04,6,3,-121.4566492,38.55347187,677,3238,4.78286558345643
"678",2006-01-04,4,1,-121.5101504,38.49814667,678,3239,4.77728613569322
"679",2006-01-04,3,7,-121.4911364,38.5646481,679,3246,4.78055964653903
"680",2006-01-04,3,7,-121.415207,38.56162032,680,3253,4.78382352941177
"681",2006-01-04,3,7,-121.4658432,38.57301361,681,3260,4.7870778267254
"682",2006-01-04,5,2,-121.5013123,38.48131474,682,3262,4.78299120234604
"683",2006-01-04,2,6,-121.4496149,38.61448373,683,3268,4.78477306002928
"684",2006-01-04,3,4,-121.4626901,38.57924878,684,3272,4.78362573099415
"685",2006-01-04,3,7,-121.5008344,38.58370044,685,3279,4.78686131386861
"686",2006-01-04,5,3,-121.472256,38.4957722,686,3282,4.78425655976676
"687",2006-01-04,5,7,-121.49508,38.47392033,687,3289,4.78748180494905
"688",2006-01-04,3,8,-121.4670272,38.5680901,688,3297,4.7921511627907
"689",2006-01-04,2,5,-121.4291378,38.65460722,689,3302,4.79245283018868
"690",2006-01-04,5,3,-121.4176675,38.45768744,690,3305,4.78985507246377
"691",2006-01-04,6,6,-121.4101636,38.53499467,691,3311,4.79160636758321
"692",2006-01-04,3,7,-121.4851916,38.57131092,692,3318,4.79479768786127
"693",2006-01-04,5,5,-121.4445499,38.44879933,693,3323,4.79509379509379
"694",2006-01-04,2,7,-121.4467735,38.62659902,694,3330,4.79827089337176
"695",2006-01-04,4,1,-121.4721784,38.52659231,695,3331,4.79280575539568
"696",2006-01-04,4,1,-121.4715167,38.52627076,696,3332,4.78735632183908
"697",2006-01-04,6,6,-121.4385055,38.53103324,697,3338,4.78909612625538
"698",2006-01-04,4,8,-121.474167,38.50102291,698,3346,4.79369627507163
"699",2006-01-04,2,7,-121.4511384,38.62935749,699,3353,4.79685264663805
"700",2006-01-04,1,7,-121.53673,38.6813822,700,3360,4.8
"701",2006-01-04,4,7,-121.4870452,38.50031738,701,3367,4.80313837375178
"702",2006-01-04,1,7,-121.5211177,38.66763857,702,3374,4.80626780626781
"703",2006-01-04,1,3,-121.4755257,38.63338067,703,3377,4.80369843527738
"704",2006-01-04,4,1,-121.4727965,38.52904451,704,3378,4.79829545454545
"705",2006-01-04,4,5,-121.4737948,38.5012711,705,3383,4.79858156028369
"706",2006-01-04,4,1,-121.473272,38.53092764,706,3384,4.79320113314448
"707",2006-01-04,4,1,-121.4746387,38.53855659,707,3385,4.78783592644979
"708",2006-01-04,2,4,-121.4393403,38.6361631,708,3389,4.78672316384181
"709",2006-01-04,4,7,-121.5305244,38.47856755,709,3396,4.78984485190409
"710",2006-01-04,2,4,-121.4458175,38.59873136,710,3400,4.7887323943662
"711",2006-01-04,1,4,-121.5061726,38.63276571,711,3404,4.78762306610408
"712",2006-01-04,2,7,-121.4244182,38.61199425,712,3411,4.79073033707865
"713",2006-01-04,6,7,-121.4347944,38.52864267,713,3418,4.79382889200561
"714",2006-01-04,1,6,-121.5223763,38.65543537,714,3424,4.79551820728291
"715",2006-01-04,1,1,-121.4755368,38.61759982,715,3425,4.79020979020979
"716",2006-01-04,6,7,-121.4634181,38.53966389,716,3432,4.79329608938547
"717",2006-01-04,5,5,-121.4052034,38.44471524,717,3437,4.79358437935844
"718",2006-01-04,4,1,-121.471459,38.52367283,718,3438,4.7883008356546
"719",2006-01-04,4,1,-121.4717471,38.52488785,719,3439,4.78303198887343
"720",2006-01-04,6,4,-121.4711438,38.54121247,720,3443,4.78194444444444
"721",2006-01-04,5,7,-121.407243,38.44254818,721,3450,4.78502080443828
"722",2006-01-04,3,4,-121.4642182,38.57094664,722,3454,4.78393351800554
"723",2006-01-04,6,5,-121.4019692,38.53913744,723,3459,4.78423236514523
"724",2006-01-04,4,1,-121.4725316,38.52799984,724,3460,4.77900552486188
"725",2006-01-04,4,1,-121.4727965,38.52904451,725,3461,4.77379310344828
"726",2006-01-04,4,1,-121.4717471,38.52488785,726,3462,4.76859504132231
"727",2006-01-04,1,1,-121.4960693,38.61346222,727,3463,4.76341127922971
"728",2006-01-04,2,5,-121.4269185,38.64448295,728,3468,4.76373626373626
"729",2006-01-04,1,4,-121.4937243,38.62284309,729,3472,4.76268861454047
"730",2006-01-04,5,7,-121.4323661,38.4599079,730,3479,4.76575342465753
"731",2006-01-04,4,1,-121.4727965,38.52904451,731,3480,4.76060191518468
"732",2006-01-04,5,7,-121.4590371,38.46866082,732,3487,4.76366120218579
"733",2006-01-04,5,5,-121.4422153,38.45354132,733,3492,4.76398362892224
"734",2006-01-04,3,5,-121.4972076,38.57512017,734,3497,4.76430517711172
"735",2006-01-04,4,1,-121.4715167,38.52627076,735,3498,4.75918367346939
"736",2006-01-04,5,7,-121.4366615,38.47587189,736,3505,4.76222826086957
"737",2006-01-04,2,5,-121.422165,38.60846273,737,3510,4.76255088195387
"738",2006-01-04,4,3,-121.4712477,38.52718667,738,3513,4.76016260162602
"739",2006-01-04,2,7,-121.4576293,38.64444404,739,3520,4.76319350473613
"740",2006-01-04,4,1,-121.4758004,38.54318603,740,3521,4.75810810810811
"741",2006-01-04,1,1,-121.5120975,38.65862177,741,3522,4.75303643724696
"742",2006-01-04,6,5,-121.4668617,38.54156627,742,3527,4.7533692722372
"743",2006-01-04,3,3,-121.4972076,38.57512017,743,3530,4.75100942126514
"744",2006-01-04,2,1,-121.4220145,38.60846198,744,3531,4.74596774193548
"745",2006-01-04,5,7,-121.4192423,38.47403927,745,3538,4.7489932885906
"746",2006-01-04,3,1,-121.3932422,38.54865343,746,3539,4.74396782841823
"747",2006-01-04,5,7,-121.4589055,38.46528543,747,3546,4.74698795180723
"748",2006-01-04,5,1,-121.4597214,38.47054773,748,3547,4.74197860962567
"749",2006-01-04,5,7,-121.4284754,38.46386486,749,3554,4.74499332443258
"750",2006-01-04,3,5,-121.4722229,38.56881137,750,3559,4.74533333333333
"751",2006-01-04,2,1,-121.4450246,38.61383575,751,3560,4.74034620505992
"752",2006-01-04,6,5,-121.3854335,38.51582822,752,3565,4.7406914893617
"753",2006-01-04,2,5,-121.4305962,38.63292418,753,3570,4.74103585657371
"754",2006-01-04,2,6,-121.3815598,38.63862878,754,3576,4.74270557029178
"755",2006-01-04,4,1,-121.4715167,38.52627076,755,3577,4.73774834437086
"756",2006-01-04,4,1,-121.4709707,38.52164684,756,3578,4.73280423280423
"757",2006-01-04,2,3,-121.4305818,38.6364856,757,3581,4.73051519154557
"758",2006-01-04,1,1,-121.4917958,38.63410671,758,3582,4.72559366754617
"759",2006-01-04,4,1,-121.4727447,38.52517524,759,3583,4.72068511198946
"760",2006-01-04,6,6,-121.4438874,38.52496323,760,3589,4.72236842105263
"761",2006-01-04,3,7,-121.4842948,38.58553089,761,3596,4.72536136662286
"762",2006-01-04,4,1,-121.4717471,38.52488785,762,3597,4.72047244094488
"763",2006-01-04,3,4,-121.4721812,38.56356918,763,3601,4.71952817824377
"764",2006-01-04,2,5,-121.4630259,38.61084789,764,3606,4.71989528795812
"765",2006-01-04,4,1,-121.4753422,38.5393973,765,3607,4.71503267973856
"766",2006-01-04,4,6,-121.4781774,38.52700121,766,3613,4.71671018276762
"767",2006-01-04,3,4,-121.4992289,38.58067298,767,3617,4.71577574967406
"768",2006-01-04,5,6,-121.432933,38.47603764,768,3623,4.71744791666667
"769",2006-01-04,5,7,-121.4401696,38.46816183,769,3630,4.72041612483745
"770",2006-01-04,3,1,-121.4841033,38.5704109,770,3631,4.71558441558442
"771",2006-01-04,4,1,-121.473272,38.53092764,771,3632,4.71076523994812
"772",2006-01-04,2,2,-121.426956,38.63589932,772,3634,4.70725388601036
"773",2006-01-04,2,4,-121.4521652,38.62966165,773,3638,4.70633893919793
"774",2006-01-04,4,3,-121.5010131,38.51314436,774,3641,4.70413436692506
"775",2006-01-04,1,1,-121.5152685,38.67124986,775,3642,4.69935483870968
"776",2006-01-04,4,5,-121.5292089,38.51385568,776,3647,4.69974226804124
"777",2006-01-04,6,8,-121.4662305,38.55630084,777,3655,4.7039897039897
"778",2006-01-04,2,7,-121.465034,38.620284,778,3662,4.70694087403599
"779",2006-01-04,4,7,-121.5233983,38.51363418,779,3669,4.70988446726573
"780",2006-01-04,5,7,-121.4985289,38.49463972,780,3676,4.71282051282051
"781",2006-01-04,4,1,-121.4758203,38.54904321,781,3677,4.70806658130602
"782",2006-01-04,3,1,-121.4974099,38.58314743,782,3678,4.70332480818414
"783",2006-01-04,6,1,-121.4704591,38.55385441,783,3679,4.69859514687101
"784",2006-01-04,2,5,-121.45544,38.60790178,784,3684,4.69897959183673
"785",2006-01-04,3,3,-121.4769139,38.57396483,785,3687,4.6968152866242
"786",2006-01-04,5,7,-121.4604164,38.46870571,786,3694,4.69974554707379
"787",2006-01-04,4,1,-121.4727965,38.52904451,787,3695,4.69504447268107
"788",2006-01-04,2,3,-121.4303283,38.63228581,788,3698,4.69289340101523
"789",2006-01-04,6,4,-121.4137192,38.52731583,789,3702,4.69201520912548
"790",2006-01-04,1,2,-121.5118637,38.67689767,790,3704,4.68860759493671
"791",2006-01-04,5,8,-121.4374736,38.4769852,791,3712,4.69279393173198
"792",2006-01-04,6,7,-121.418769,38.51503396,792,3719,4.69570707070707
"793",2006-01-04,2,6,-121.3815598,38.63862878,793,3725,4.69735182849937
"794",2006-01-04,5,2,-121.4861143,38.47914754,794,3727,4.69395465994962
"795",2006-01-04,1,2,-121.4973299,38.61236933,795,3729,4.69056603773585
"796",2006-01-04,4,1,-121.4717471,38.52488785,796,3730,4.68592964824121
"797",2006-01-04,6,1,-121.4346721,38.54231415,797,3731,4.68130489335006
"798",2006-01-04,6,5,-121.452695,38.54469916,798,3736,4.68170426065163
"799",2006-01-04,6,5,-121.4525985,38.54452845,799,3741,4.68210262828536
"800",2006-01-04,2,5,-121.4700116,38.63482465,800,3746,4.6825
"801",2006-01-04,6,1,-121.4723384,38.55555724,801,3747,4.67790262172285
"802",2006-01-04,3,6,-121.4924524,38.58614084,802,3753,4.67955112219451
"803",2006-01-04,5,1,-121.4619674,38.49603233,803,3754,4.67496886674969
"804",2006-01-04,4,1,-121.4852516,38.53293942,804,3755,4.67039800995025
"805",2006-01-04,5,2,-121.482931,38.48940865,805,3757,4.66708074534161
"806",2006-01-04,4,2,-121.4827604,38.49850245,806,3759,4.66377171215881
"807",2006-01-04,2,3,-121.4569383,38.63679611,807,3762,4.66171003717472
"808",2006-01-04,3,2,-121.4960076,38.58010158,808,3764,4.65841584158416
"809",2006-01-04,5,2,-121.448452,38.47435531,809,3766,4.65512978986403
"810",2006-01-04,2,4,-121.4367656,38.60888339,810,3770,4.65432098765432
"811",2006-01-04,4,1,-121.471459,38.52367283,811,3771,4.6498150431566
"812",2006-01-04,3,4,-121.4795444,38.57682697,812,3775,4.64901477832512
"813",2006-01-04,3,4,-121.470898,38.56776187,813,3779,4.64821648216482
"814",2006-01-04,6,9,-121.4147208,38.50492491,814,3788,4.65356265356265
"815",2006-01-04,6,1,-121.4704591,38.55385441,815,3789,4.64907975460123
"816",2006-01-04,5,1,-121.4466002,38.46223959,816,3790,4.64460784313725
"817",2006-01-04,4,1,-121.484665,38.55559631,817,3791,4.64014687882497
"818",2006-01-04,4,1,-121.4752437,38.53710124,818,3792,4.63569682151589
"819",2006-01-04,1,7,-121.5078891,38.6412195,819,3799,4.63858363858364
"820",2006-01-04,3,4,-121.4648897,38.57188611,820,3803,4.63780487804878
"821",2006-01-04,3,1,-121.5014996,38.58062786,821,3804,4.63337393422655
"822",2006-01-04,3,1,-121.5032275,38.58165678,822,3805,4.62895377128954
"823",2006-01-04,4,1,-121.4717471,38.52488785,823,3806,4.62454434993925
"824",2006-01-04,3,1,-121.4753282,38.56318807,824,3807,4.62014563106796
"825",2006-01-04,2,6,-121.3815598,38.63862878,825,3813,4.62181818181818
"826",2006-01-04,3,6,-121.4966071,38.57991197,826,3819,4.62348668280872
"827",2006-01-04,2,4,-121.4376102,38.63712953,827,3823,4.62273276904474
"828",2006-01-04,2,7,-121.4585103,38.60683427,828,3830,4.6256038647343
"829",2006-01-04,3,1,-121.4648897,38.57188611,829,3831,4.62123039806996
"830",2006-01-04,1,3,-121.4916239,38.61157282,830,3834,4.61927710843374
"831",2006-01-04,3,4,-121.504007,38.58426601,831,3838,4.61853188929001
"832",2006-01-04,1,8,-121.4911353,38.62806276,832,3846,4.62259615384615
"833",2006-01-04,6,1,-121.4237449,38.51602543,833,3847,4.61824729891957
"834",2006-01-04,3,4,-121.4648897,38.57188611,834,3851,4.61750599520384
"835",2006-01-04,4,1,-121.4717471,38.52488785,835,3852,4.61317365269461
"836",2006-01-04,6,1,-121.4615285,38.54359005,836,3853,4.60885167464115
"837",2006-01-04,4,1,-121.4745855,38.53627722,837,3854,4.60454002389486
"838",2006-01-04,5,1,-121.4714034,38.48632776,838,3855,4.60023866348449
"839",2006-01-04,4,1,-121.4717471,38.52488785,839,3856,4.59594755661502
"840",2006-01-04,6,1,-121.462171,38.54370562,840,3857,4.59166666666667
"841",2006-01-04,6,1,-121.4615285,38.54359005,841,3858,4.58739595719382
"842",2006-01-04,4,1,-121.4725316,38.52799984,842,3859,4.58313539192399
"843",2006-01-04,1,8,-121.4984478,38.6270814,843,3867,4.58718861209964
"844",2006-01-04,6,1,-121.4615285,38.54359005,844,3868,4.58293838862559
"845",2006-01-04,1,2,-121.52827,38.60889406,845,3870,4.57988165680473
"846",2006-01-04,4,4,-121.519979,38.51694262,846,3874,4.57919621749409
"847",2006-01-04,5,5,-121.427261,38.47245642,847,3879,4.57969303423849
"848",2006-01-04,2,5,-121.3829415,38.63715334,848,3884,4.58018867924528
"849",2006-01-04,2,6,-121.4520581,38.59714644,849,3890,4.58186101295642
"850",2006-01-04,3,1,-121.4648897,38.57188611,850,3891,4.57764705882353
"851",2006-01-04,1,4,-121.4759243,38.61154129,851,3895,4.57696827262045
"852",2006-01-04,3,5,-121.4813431,38.57336692,852,3900,4.57746478873239
"853",2006-01-04,1,7,-121.4975291,38.67300311,853,3907,4.58030480656506
"854",2006-01-04,4,4,-121.472843,38.53080212,854,3911,4.57962529274005
"855",2006-01-04,5,1,-121.4503108,38.47429277,855,3912,4.57543859649123
"856",2006-01-04,3,5,-121.4878161,38.5857662,856,3917,4.57593457943925
"857",2006-01-04,3,2,-121.4868341,38.58464151,857,3919,4.57292882147024
"858",2006-01-04,2,3,-121.4686236,38.65008296,858,3922,4.57109557109557
"859",2006-01-04,6,1,-121.4229945,38.51763356,859,3923,4.56693830034924
"860",2006-01-04,4,1,-121.4755662,38.54031271,860,3924,4.56279069767442
"861",2006-01-04,2,1,-121.423349,38.59664183,861,3925,4.55865272938444
"862",2006-01-04,6,5,-121.4337511,38.50591483,862,3930,4.55916473317865
"863",2006-01-04,6,3,-121.4101636,38.53499467,863,3933,4.55735805330243
"864",2006-01-04,3,2,-121.5000936,38.58207989,864,3935,4.55439814814815
"865",2006-01-04,1,6,-121.4984478,38.6270814,865,3941,4.55606936416185
"866",2006-01-04,4,1,-121.472439,38.52728547,866,3942,4.55196304849885
"867",2006-01-04,5,5,-121.4533502,38.48335233,867,3947,4.55247981545559
"868",2006-01-04,5,5,-121.4340027,38.47417289,868,3952,4.55299539170507
"869",2006-01-04,6,7,-121.4614322,38.55727813,869,3959,4.55581127733026
"870",2006-01-04,3,6,-121.4910973,38.58679941,870,3965,4.55747126436782
"871",2006-01-04,6,7,-121.4247349,38.51027484,871,3972,4.56027554535017
"872",2006-01-04,5,1,-121.4202627,38.45891145,872,3973,4.55619266055046
"873",2006-01-04,4,7,-121.4990409,38.56211513,873,3980,4.55899198167239
"874",2006-01-04,5,4,-121.443216,38.47434943,874,3984,4.558352402746
"875",2006-01-04,6,4,-121.4605242,38.54739949,875,3988,4.55771428571429
"876",2006-01-04,4,6,-121.5430401,38.49720765,876,3994,4.55936073059361
"877",2006-01-04,2,5,-121.4415417,38.61837728,877,3999,4.55986316989738
"878",2006-01-04,5,1,-121.4803426,38.48694218,878,4000,4.55580865603645
"879",2006-01-04,5,1,-121.4196575,38.47581524,879,4001,4.55176336746303
"880",2006-01-04,2,3,-121.4226379,38.60667473,880,4004,4.55
"881",2006-01-04,5,3,-121.4631494,38.49079582,881,4007,4.54824063564132
"882",2006-01-04,1,7,-121.5040161,38.62823395,882,4014,4.55102040816327
"883",2006-01-04,3,8,-121.4926811,38.5923559,883,4022,4.55492638731597
"884",2006-01-04,6,5,-121.4091401,38.53954773,884,4027,4.55542986425339
"885",2006-01-04,5,1,-121.4223876,38.47038918,885,4028,4.55141242937853
"886",2006-01-04,3,7,-121.4347032,38.57415083,886,4035,4.55417607223476
"887",2006-01-04,5,1,-121.502811,38.49284864,887,4036,4.55016910935738
"888",2006-01-04,6,7,-121.4642292,38.5396649,888,4043,4.55292792792793
"889",2006-01-04,4,1,-121.4918326,38.56216059,889,4044,4.54893138357705
"890",2006-01-04,1,3,-121.4785648,38.60700868,890,4047,4.54719101123596
"891",2006-01-04,3,4,-121.4149596,38.55553953,891,4051,4.54657687991021
"892",2006-01-04,5,8,-121.4323127,38.44376695,892,4059,4.55044843049327
"893",2006-01-04,6,1,-121.4278566,38.54463119,893,4060,4.5464725643897
"894",2006-01-04,2,9,-121.4593714,38.61003182,894,4069,4.55145413870246
"895",2006-01-04,2,3,-121.4593714,38.61003182,895,4072,4.54972067039106
"896",2006-01-04,5,1,-121.4196575,38.47581524,896,4073,4.54575892857143
"897",2006-01-04,6,6,-121.4326059,38.54141435,897,4079,4.54738015607581
"898",2006-01-04,4,5,-121.4768285,38.52217873,898,4084,4.54788418708241
"899",2006-01-04,1,3,-121.4706061,38.61747853,899,4087,4.54616240266963
"900",2006-01-04,5,2,-121.4562432,38.48789953,900,4089,4.54333333333333
"901",2006-01-04,3,3,-121.4910186,38.56987859,901,4092,4.54162042175361
"902",2006-01-04,5,7,-121.4742605,38.48927894,902,4099,4.54434589800443
"903",2006-01-04,3,6,-121.4976906,38.57905171,903,4105,4.54595791805094
"904",2006-01-04,5,5,-121.4160666,38.46598861,904,4110,4.54646017699115
"905",2006-01-04,5,2,-121.4566887,38.48857712,905,4112,4.54364640883978
"906",2006-01-04,5,1,-121.505075,38.48126775,906,4113,4.53973509933775
"907",2006-01-04,6,4,-121.4558633,38.54097138,907,4117,4.53914002205072
"908",2006-01-04,2,5,-121.4164146,38.63248017,908,4122,4.53964757709251
"909",2006-01-05,4,4,-121.5071286,38.49297696,909,4126,4.53905390539054
"910",2006-01-05,4,7,-121.5270041,38.5000621,910,4133,4.54175824175824
"911",2006-01-05,6,4,-121.3827886,38.51451804,911,4137,4.54116355653128
"912",2006-01-05,2,3,-121.4566324,38.65900657,912,4140,4.53947368421053
"913",2006-01-05,3,4,-121.3858526,38.55486974,913,4144,4.53888280394304
"914",2006-01-05,2,5,-121.4153006,38.63298804,914,4149,4.53938730853392
"915",2006-01-05,1,7,-121.5409492,38.66050526,915,4156,4.54207650273224
"916",2006-01-05,3,7,-121.4291044,38.55343263,916,4163,4.54475982532751
"917",2006-01-05,6,1,-121.4671318,38.55128541,917,4164,4.54089422028353
"918",2006-01-05,3,3,-121.4847746,38.58885287,918,4167,4.53921568627451
"919",2006-01-05,6,8,-121.4412734,38.54273614,919,4175,4.54298150163221
"920",2006-01-05,6,1,-121.4592505,38.55906655,920,4176,4.53913043478261
"921",2006-01-05,3,5,-121.4746508,38.57158209,921,4181,4.53963083604777
"922",2006-01-05,4,5,-121.5269234,38.51382164,922,4186,4.54013015184382
"923",2006-01-05,1,4,-121.5028488,38.63449242,923,4190,4.53954496208017
"924",2006-01-05,1,7,-121.5313256,38.61147666,924,4197,4.54220779220779
"925",2006-01-05,2,3,-121.450115,38.60909032,925,4200,4.54054054054054
"926",2006-01-05,3,1,-121.4474724,38.57120018,926,4201,4.53671706263499
"927",2006-01-05,5,1,-121.4412886,38.46620664,927,4202,4.53290183387271
"928",2006-01-05,3,3,-121.4099656,38.55768622,928,4205,4.53125
"929",2006-01-05,5,8,-121.4661466,38.47029475,929,4213,4.53498385360603
"930",2006-01-05,2,2,-121.4470349,38.60960014,930,4215,4.53225806451613
"931",2006-01-05,6,5,-121.4647617,38.53952458,931,4220,4.5327604726101
"932",2006-01-05,6,5,-121.4188647,38.51229947,932,4225,4.53326180257511
"933",2006-01-05,2,7,-121.467184,38.64966171,933,4232,4.53590568060021
"934",2006-01-05,5,5,-121.5017288,38.4842135,934,4237,4.53640256959315
"935",2006-01-05,2,7,-121.4576427,38.63532759,935,4244,4.53903743315508
"936",2006-01-05,2,7,-121.4578075,38.62884519,936,4251,4.54166666666667
"937",2006-01-05,2,5,-121.4291435,38.64733599,937,4256,4.54215581643543
"938",2006-01-05,3,8,-121.5025898,38.5978633,938,4264,4.54584221748401
"939",2006-01-05,3,5,-121.3850336,38.55495326,939,4269,4.54632587859425
"940",2006-01-05,6,5,-121.4108912,38.50063002,940,4274,4.5468085106383
"941",2006-01-05,2,5,-121.4508063,38.61293518,941,4279,4.54729011689692
"942",2006-01-05,3,5,-121.4783751,38.56643382,942,4284,4.54777070063694
"943",2006-01-05,1,1,-121.4755625,38.61124309,943,4285,4.5440084835631
"944",2006-01-05,3,6,-121.4639956,38.56286705,944,4291,4.54555084745763
"945",2006-01-05,6,5,-121.3907012,38.52149079,945,4296,4.54603174603175
"946",2006-01-05,1,9,-121.4765366,38.63872883,946,4305,4.5507399577167
"947",2006-01-05,6,5,-121.465102,38.54870584,947,4310,4.55121436114044
"948",2006-01-05,2,6,-121.4673019,38.65263061,948,4316,4.55274261603375
"949",2006-01-05,1,5,-121.5341593,38.64378844,949,4321,4.55321390937829
"950",2006-01-05,6,1,-121.4538401,38.54675579,950,4322,4.54947368421053
"951",2006-01-05,6,8,-121.4170347,38.53139385,951,4330,4.55310199789695
"952",2006-01-05,6,1,-121.4501933,38.54674127,952,4331,4.54936974789916
"953",2006-01-05,3,3,-121.4344738,38.56425057,953,4334,4.54774396642183
"954",2006-01-05,2,2,-121.4654754,38.64731156,954,4336,4.54507337526205
"955",2006-01-05,4,7,-121.4940439,38.53291505,955,4343,4.54764397905759
"956",2006-01-05,6,4,-121.376496,38.52390843,956,4347,4.54707112970711
"957",2006-01-05,4,5,-121.515322,38.48369463,957,4352,4.54754440961338
"958",2006-01-05,6,7,-121.4527491,38.5422061,958,4359,4.55010438413361
"959",2006-01-05,6,3,-121.4438954,38.52393354,959,4362,4.54848800834202
"960",2006-01-05,5,5,-121.4255728,38.46825223,960,4367,4.54895833333333
"961",2006-01-05,3,5,-121.4807105,38.561757,961,4372,4.54942767950052
"962",2006-01-05,5,4,-121.4133413,38.45718227,962,4376,4.54885654885655
"963",2006-01-05,6,7,-121.4124426,38.50022327,963,4383,4.55140186915888
"964",2006-01-05,3,5,-121.4868341,38.58464151,964,4388,4.55186721991701
"965",2006-01-05,3,4,-121.48165,38.57686937,965,4392,4.55129533678756
"966",2006-01-05,2,4,-121.42747,38.60154457,966,4396,4.55072463768116
"967",2006-01-05,5,7,-121.4368769,38.47425283,967,4403,4.55325749741468
"968",2006-01-05,6,1,-121.452695,38.54469916,968,4404,4.5495867768595
"969",2006-01-05,4,5,-121.4894757,38.55576316,969,4409,4.5500515995872
"970",2006-01-05,4,5,-121.4801938,38.55539783,970,4414,4.55051546391753
"971",2006-01-05,4,2,-121.47576,38.54106323,971,4416,4.54788877445932
"972",2006-01-05,3,6,-121.4966071,38.57991197,972,4422,4.54938271604938
"973",2006-01-05,5,7,-121.4585217,38.47259883,973,4429,4.551901336074
"974",2006-01-05,2,1,-121.4490916,38.61200165,974,4430,4.5482546201232
"975",2006-01-05,1,7,-121.4755286,38.6296517,975,4437,4.55076923076923
"976",2006-01-05,2,5,-121.4658695,38.60219485,976,4442,4.55122950819672
"977",2006-01-05,5,5,-121.4846405,38.48055239,977,4447,4.55168884339816
"978",2006-01-05,5,6,-121.4305743,38.47921958,978,4453,4.55316973415133
"979",2006-01-05,6,1,-121.4567702,38.54676409,979,4454,4.54954034729316
"980",2006-01-05,6,1,-121.4676206,38.55700746,980,4455,4.54591836734694
"981",2006-01-05,3,4,-121.4795487,38.57383941,981,4459,4.5453618756371
"982",2006-01-05,6,1,-121.4501933,38.54674127,982,4460,4.54175152749491
"983",2006-01-05,6,4,-121.429358,38.51996349,983,4464,4.5412004069176
"984",2006-01-05,6,1,-121.4575843,38.54454919,984,4465,4.53760162601626
"985",2006-01-05,5,3,-121.4847037,38.49502927,985,4468,4.53604060913706
"986",2006-01-05,6,1,-121.4665635,38.54918489,986,4469,4.53245436105477
"987",2006-01-05,2,2,-121.4284714,38.59971248,987,4471,4.52988855116515
"988",2006-01-05,5,7,-121.4565171,38.4656669,988,4478,4.53238866396761
"989",2006-01-05,2,2,-121.4251049,38.6162429,989,4480,4.52982810920121
"990",2006-01-05,3,7,-121.4923366,38.58570373,990,4487,4.53232323232323
"991",2006-01-05,2,3,-121.4629549,38.6374722,991,4490,4.53077699293643
"992",2006-01-05,6,1,-121.4575843,38.54454919,992,4491,4.52721774193548
"993",2006-01-05,2,8,-121.456171,38.60108154,993,4499,4.53071500503525
"994",2006-01-05,6,7,-121.4148428,38.50196814,994,4506,4.53319919517103
"995",2006-01-05,6,1,-121.4724356,38.55612335,995,4507,4.52964824120603
"996",2006-01-05,6,1,-121.4575843,38.54454919,996,4508,4.52610441767068
"997",2006-01-05,1,5,-121.5139523,38.60387022,997,4513,4.52657973921765
"998",2006-01-05,3,5,-121.4392594,38.57167967,998,4518,4.52705410821643
"999",2006-01-05,3,5,-121.4926811,38.5923559,999,4523,4.52752752752753
"1000",2006-01-05,2,3,-121.454431,38.6405243,1000,4526,4.526
"1001",2006-01-05,6,1,-121.4724356,38.55612335,1001,4527,4.52247752247752
"1002",2006-01-05,6,1,-121.4647218,38.54718283,1002,4528,4.5189620758483
"1003",2006-01-05,3,2,-121.5040444,38.56932279,1003,4530,4.51645064805583
"1004",2006-01-05,3,5,-121.4344469,38.56059283,1004,4535,4.51693227091633
"1005",2006-01-05,5,2,-121.4305743,38.47921958,1005,4537,4.51442786069652
"1006",2006-01-05,1,5,-121.5090158,38.6469111,1006,4542,4.51491053677932
"1007",2006-01-05,6,1,-121.4566198,38.54676613,1007,4543,4.51142005958292
"1008",2006-01-05,6,1,-121.4550394,38.54676419,1008,4544,4.50793650793651
"1009",2006-01-05,5,7,-121.4348784,38.47431447,1009,4551,4.51040634291378
"1010",2006-01-05,5,7,-121.4968374,38.47584192,1010,4558,4.51287128712871
"1011",2006-01-05,2,4,-121.439243,38.61292096,1011,4562,4.51236399604352
"1012",2006-01-05,1,4,-121.5055312,38.63589608,1012,4566,4.51185770750988
"1013",2006-01-05,6,3,-121.4687016,38.54850275,1013,4569,4.51036525172754
"1014",2006-01-05,4,5,-121.5148282,38.51730281,1014,4574,4.51084812623274
"1015",2006-01-05,6,6,-121.4687016,38.54850275,1015,4580,4.51231527093596
"1016",2006-01-05,6,1,-121.4401801,38.53056905,1016,4581,4.50885826771654
"1017",2006-01-05,6,3,-121.4096022,38.5014335,1017,4584,4.50737463126844
"1018",2006-01-05,2,3,-121.4250133,38.61980119,1018,4587,4.50589390962672
"1019",2006-01-05,6,1,-121.4116315,38.50366806,1019,4588,4.50245338567223
"1020",2006-01-05,4,2,-121.4827348,38.49575914,1020,4590,4.5
"1021",2006-01-05,5,1,-121.4564025,38.48807602,1021,4591,4.49657198824682
"1022",2006-01-05,2,1,-121.4597918,38.63768815,1022,4592,4.49315068493151
"1023",2006-01-05,2,1,-121.4316073,38.62159114,1023,4593,4.48973607038123
"1024",2006-01-05,5,1,-121.4180465,38.44973707,1024,4594,4.486328125
"1025",2006-01-05,6,6,-121.4666875,38.54802942,1025,4600,4.48780487804878
"1026",2006-01-05,6,1,-121.452695,38.54469916,1026,4601,4.48440545808967
"1027",2006-01-05,5,5,-121.4180465,38.44973707,1027,4606,4.48490749756573
"1028",2006-01-05,4,5,-121.5319277,38.51282875,1028,4611,4.48540856031128
"1029",2006-01-05,6,3,-121.413464,38.507324,1029,4614,4.48396501457726
"1030",2006-01-05,6,2,-121.4438954,38.52393354,1030,4616,4.48155339805825
"1031",2006-01-05,1,6,-121.5327875,38.66611003,1031,4622,4.48302618816683
"1032",2006-01-05,6,5,-121.4676206,38.55700746,1032,4627,4.48352713178295
"1033",2006-01-05,3,2,-121.4879497,38.58615671,1033,4629,4.4811229428848
"1034",2006-01-05,3,7,-121.4827304,38.59284733,1034,4636,4.48355899419729
"1035",2006-01-05,6,7,-121.46217,38.54337336,1035,4643,4.48599033816425
"1036",2006-01-05,5,7,-121.4571242,38.46528532,1036,4650,4.48841698841699
"1037",2006-01-05,6,1,-121.4125616,38.53587459,1037,4651,4.48505303760849
"1038",2006-01-05,2,8,-121.4198325,38.64094112,1038,4659,4.48843930635838
"1039",2006-01-05,6,6,-121.3846751,38.52921623,1039,4665,4.48989412897016
"1040",2006-01-05,2,3,-121.4665401,38.60611091,1040,4668,4.48846153846154
"1041",2006-01-05,2,5,-121.4719145,38.65535922,1041,4673,4.48895292987512
"1042",2006-01-05,3,5,-121.4836302,38.57150442,1042,4678,4.489443378119
"1043",2006-01-05,2,1,-121.424418,38.63369822,1043,4679,4.48609779482263
"1044",2006-01-05,6,1,-121.4650094,38.5447238,1044,4680,4.48275862068965
"1045",2006-01-05,1,3,-121.5222297,38.62873062,1045,4683,4.48133971291866
"1046",2006-01-05,4,1,-121.4958991,38.5286285,1046,4684,4.47801147227533
"1047",2006-01-05,5,1,-121.491119,38.48764914,1047,4685,4.47468958930277
"1048",2006-01-05,6,7,-121.4101987,38.50578888,1048,4692,4.47709923664122
"1049",2006-01-05,4,2,-121.482779,38.50123749,1049,4694,4.47473784556721
"1050",2006-01-05,3,5,-121.3952354,38.56019414,1050,4699,4.4752380952381
"1051",2006-01-05,6,1,-121.4105955,38.51402327,1051,4700,4.47193149381541
"1052",2006-01-05,3,5,-121.43864,38.55792771,1052,4705,4.47243346007605
"1053",2006-01-05,6,1,-121.4125616,38.53587459,1053,4706,4.46913580246914
"1054",2006-01-05,5,7,-121.4116006,38.44083226,1054,4713,4.47153700189753
"1055",2006-01-05,6,1,-121.4501933,38.54674127,1055,4714,4.46824644549763
"1056",2006-01-05,4,7,-121.4990149,38.52199137,1056,4721,4.47064393939394
"1057",2006-01-05,3,5,-121.3831694,38.56429883,1057,4726,4.47114474929044
"1058",2006-01-05,5,3,-121.4127165,38.44227407,1058,4729,4.46975425330813
"1059",2006-01-05,1,4,-121.4835296,38.62984691,1059,4733,4.46931067044382
"1060",2006-01-05,3,3,-121.4944065,38.57402607,1060,4736,4.46792452830189
"1061",2006-01-05,5,4,-121.4378887,38.47528199,1061,4740,4.4674835061263
"1062",2006-01-05,6,7,-121.4421623,38.52563317,1062,4747,4.469868173258
"1063",2006-01-05,3,1,-121.4979339,38.58026647,1063,4748,4.46660395108184
"1064",2006-01-05,6,1,-121.4144333,38.52506502,1064,4749,4.46334586466165
"1065",2006-01-05,2,3,-121.4141322,38.63629375,1065,4752,4.46197183098592
"1066",2006-01-05,2,5,-121.4671356,38.60134944,1066,4757,4.4624765478424
"1067",2006-01-05,6,5,-121.4080836,38.52023278,1067,4762,4.46298031865042
"1068",2006-01-05,6,7,-121.4303709,38.54721929,1068,4769,4.46535580524345
"1069",2006-01-05,1,6,-121.4987037,38.61309746,1069,4775,4.46679139382601
"1070",2006-01-05,2,3,-121.4647115,38.6194093,1070,4778,4.46542056074766
"1071",2006-01-05,3,7,-121.4791371,38.57368379,1071,4785,4.46778711484594
"1072",2006-01-05,2,5,-121.4211729,38.59875634,1072,4790,4.46828358208955
"1073",2006-01-05,1,7,-121.5139523,38.60387022,1073,4797,4.47064305684995
"1074",2006-01-05,3,8,-121.4972694,38.5797446,1074,4805,4.47392923649907
"1075",2006-01-05,6,5,-121.452695,38.54469916,1075,4810,4.47441860465116
"1076",2006-01-05,4,5,-121.5236897,38.51658451,1076,4815,4.47490706319703
"1077",2006-01-05,6,5,-121.3906925,38.53029154,1077,4820,4.47539461467038
"1078",2006-01-05,5,7,-121.4530858,38.48230213,1078,4827,4.47773654916512
"1079",2006-01-05,5,4,-121.4263125,38.47138354,1079,4831,4.4772937905468
"1080",2006-01-05,5,7,-121.4530858,38.48230213,1080,4838,4.47962962962963
"1081",2006-01-05,6,1,-121.4501933,38.54674127,1081,4839,4.47641073080481
"1082",2006-01-05,2,6,-121.4686236,38.65008296,1082,4845,4.47781885397412
"1083",2006-01-05,5,2,-121.4561046,38.48728104,1083,4847,4.47553093259464
"1084",2006-01-05,2,7,-121.4248084,38.6230651,1084,4854,4.47785977859779
"1085",2006-01-05,4,5,-121.4980099,38.52224238,1085,4859,4.47834101382488
"1086",2006-01-05,1,1,-121.5171426,38.61437028,1086,4860,4.47513812154696
"1087",2006-01-05,4,4,-121.5264068,38.50108389,1087,4864,4.47470101195952
"1088",2006-01-05,3,7,-121.4701627,38.57164676,1088,4871,4.47702205882353
"1089",2006-01-05,6,7,-121.4384155,38.54068756,1089,4878,4.47933884297521
"1090",2006-01-05,6,5,-121.388176,38.51718828,1090,4883,4.47981651376147
"1091",2006-01-05,2,5,-121.4452806,38.63446175,1091,4888,4.48029330889093
"1092",2006-01-05,2,5,-121.4642627,38.61112822,1092,4893,4.48076923076923
"1093",2006-01-05,4,1,-121.4960651,38.53085892,1093,4894,4.4775846294602
"1094",2006-01-05,5,5,-121.4582078,38.49142905,1094,4899,4.47806215722121
"1095",2006-01-05,5,7,-121.4885865,38.48367557,1095,4906,4.48036529680365
"1096",2006-01-05,5,6,-121.4987217,38.4925509,1096,4912,4.48175182481752
"1097",2006-01-05,4,4,-121.4734384,38.53159017,1097,4916,4.48131267092069
"1098",2006-01-05,3,5,-121.3894636,38.55013285,1098,4921,4.48178506375228
"1099",2006-01-05,2,5,-121.4430679,38.6322434,1099,4926,4.48225659690628
"1100",2006-01-05,3,4,-121.4852542,38.56796664,1100,4930,4.48181818181818
"1101",2006-01-05,2,2,-121.4472415,38.61138598,1101,4932,4.47956403269755
"1102",2006-01-05,3,1,-121.4925953,38.57884551,1102,4933,4.47640653357532
"1103",2006-01-05,3,7,-121.4987072,38.5797426,1103,4940,4.47869446962829
"1104",2006-01-05,5,7,-121.4348784,38.47431447,1104,4947,4.48097826086957
"1105",2006-01-05,4,7,-121.526669,38.50476176,1105,4954,4.48325791855204
"1106",2006-01-05,4,4,-121.5175955,38.52363278,1106,4958,4.48282097649186
"1107",2006-01-05,6,3,-121.455081,38.55642737,1107,4961,4.48148148148148
"1108",2006-01-05,3,7,-121.4711377,38.56940229,1108,4968,4.48375451263538
"1109",2006-01-05,2,5,-121.4595717,38.62054971,1109,4973,4.48422001803427
"1110",2006-01-05,6,7,-121.4231478,38.51207103,1110,4980,4.48648648648649
"1111",2006-01-05,6,5,-121.4357391,38.50553737,1111,4985,4.48694869486949
"1112",2006-01-05,5,4,-121.4561511,38.48943682,1112,4989,4.48651079136691
"1113",2006-01-05,1,2,-121.4854095,38.62645306,1113,4991,4.48427672955975
"1114",2006-01-05,1,2,-121.5107812,38.6172378,1114,4993,4.48204667863555
"1115",2006-01-05,6,2,-121.4708274,38.54097213,1115,4995,4.47982062780269
"1116",2006-01-05,3,8,-121.48165,38.57686937,1116,5003,4.48297491039427
"1117",2006-01-05,4,5,-121.4959901,38.52663259,1117,5008,4.48343777976723
"1118",2006-01-05,3,3,-121.4106183,38.55529508,1118,5011,4.48211091234347
"1119",2006-01-05,4,6,-121.479014,38.53881527,1119,5017,4.48346738159071
"1120",2006-01-05,3,7,-121.4696858,38.57274295,1120,5024,4.48571428571429
"1121",2006-01-05,2,2,-121.4547111,38.62863295,1121,5026,4.48349687778769
"1122",2006-01-05,4,6,-121.479014,38.53881527,1122,5032,4.48484848484848
"1123",2006-01-05,4,6,-121.479014,38.53881527,1123,5038,4.48619768477293
"1124",2006-01-05,4,6,-121.479014,38.53881527,1124,5044,4.48754448398576
"1125",2006-01-05,4,6,-121.479014,38.53881527,1125,5050,4.48888888888889
"1126",2006-01-05,4,6,-121.479014,38.53881527,1126,5056,4.49023090586146
"1127",2006-01-05,6,7,-121.461195,38.54654313,1127,5063,4.4924578527063
"1128",2006-01-05,4,8,-121.5197132,38.51333061,1128,5071,4.49556737588652
"1129",2006-01-05,4,5,-121.5119634,38.4941233,1129,5076,4.49601417183348
"1130",2006-01-05,2,7,-121.4258885,38.59891162,1130,5083,4.49823008849557
"1131",2006-01-05,3,7,-121.4919713,38.5790295,1131,5090,4.50044208664898
"1132",2006-01-05,1,7,-121.5213875,38.60504898,1132,5097,4.50265017667845
"1133",2006-01-05,5,1,-121.4627597,38.49940254,1133,5098,4.49955869373345
"1134",2006-01-05,4,7,-121.4887384,38.5605653,1134,5105,4.50176366843034
"1135",2006-01-05,6,4,-121.44887,38.53789577,1135,5109,4.50132158590308
"1136",2006-01-05,1,7,-121.4803865,38.60961727,1136,5116,4.50352112676056
"1137",2006-01-05,3,5,-121.466574,38.56181353,1137,5121,4.50395778364116
"1138",2006-01-05,1,5,-121.5064178,38.62718153,1138,5126,4.50439367311072
"1139",2006-01-05,4,4,-121.5441011,38.49849968,1139,5130,4.50395083406497
"1140",2006-01-05,5,3,-121.4592772,38.49601155,1140,5133,4.50263157894737
"1141",2006-01-05,5,6,-121.4452487,38.46807374,1141,5139,4.50394390885188
"1142",2006-01-05,6,4,-121.4149108,38.50646635,1142,5143,4.50350262697023
"1143",2006-01-05,6,7,-121.4331388,38.50557133,1143,5150,4.50568678915136
"1144",2006-01-05,6,5,-121.4353438,38.52502344,1144,5155,4.50611888111888
"1145",2006-01-05,2,6,-121.4384217,38.64744173,1145,5161,4.50742358078603
"1146",2006-01-05,1,4,-121.4835296,38.62984691,1146,5165,4.50698080279232
"1147",2006-01-05,2,6,-121.3815598,38.63862878,1147,5171,4.50828247602441
"1148",2006-01-05,4,7,-121.5173976,38.48259396,1148,5178,4.51045296167247
"1149",2006-01-05,6,5,-121.4136728,38.53381252,1149,5183,4.51087902523934
"1150",2006-01-05,2,3,-121.4686236,38.65008296,1150,5186,4.5095652173913
"1151",2006-01-05,6,7,-121.4345579,38.53907886,1151,5193,4.51172893136403
"1152",2006-01-05,2,3,-121.4487821,38.61446329,1152,5196,4.51041666666667
"1153",2006-01-05,6,4,-121.469623,38.53885224,1153,5200,4.50997398091934
"1154",2006-01-05,2,5,-121.4563024,38.61138219,1154,5205,4.5103986135182
"1155",2006-01-05,4,7,-121.477487,38.54967957,1155,5212,4.51255411255411
"1156",2006-01-05,3,5,-121.4917691,38.56664992,1156,5217,4.51297577854671
"1157",2006-01-05,2,5,-121.4592018,38.63700441,1157,5222,4.51339671564391
"1158",2006-01-05,4,7,-121.4805652,38.53464567,1158,5229,4.51554404145078
"1159",2006-01-05,1,7,-121.5128115,38.60643287,1159,5236,4.51768766177739
"1160",2006-01-05,2,7,-121.4596681,38.62306819,1160,5243,4.5198275862069
"1161",2006-01-05,5,4,-121.4982461,38.47620226,1161,5247,4.51937984496124
"1162",2006-01-05,2,4,-121.4206574,38.59803706,1162,5251,4.51893287435456
"1163",2006-01-05,4,2,-121.5275585,38.51027649,1163,5253,4.51676698194325
"1164",2006-01-05,2,6,-121.3815598,38.63862878,1164,5259,4.5180412371134
"1165",2006-01-05,1,2,-121.4755625,38.61124309,1165,5261,4.51587982832618
"1166",2006-01-05,3,4,-121.4852542,38.56796664,1166,5265,4.51543739279588
"1167",2006-01-05,6,4,-121.4351262,38.5149777,1167,5269,4.51499571550985
"1168",2006-01-05,4,4,-121.5128862,38.4802355,1168,5273,4.51455479452055
"1169",2006-01-05,3,4,-121.4986248,38.58052209,1169,5277,4.51411462788708
"1170",2006-01-05,6,7,-121.4697609,38.55463655,1170,5284,4.51623931623932
"1171",2006-01-05,3,7,-121.483793,38.58138778,1171,5291,4.51836037574722
"1172",2006-01-05,6,8,-121.4479715,38.53880039,1172,5299,4.52133105802048
"1173",2006-01-05,1,4,-121.5019273,38.61355621,1173,5303,4.52088661551577
"1174",2006-01-05,1,8,-121.4737594,38.63078873,1174,5311,4.52385008517888
"1175",2006-01-05,5,3,-121.4684313,38.48151147,1175,5314,4.52255319148936
"1176",2006-01-05,4,7,-121.5130396,38.52075518,1176,5321,4.52465986394558
"1177",2006-01-06,3,7,-121.43864,38.55792771,1177,5328,4.5267629566695
"1178",2006-01-06,2,4,-121.4364452,38.61177605,1178,5332,4.52631578947368
"1179",2006-01-06,2,7,-121.4384528,38.59683138,1179,5339,4.5284139100933
"1180",2006-01-06,5,3,-121.4581288,38.47191051,1180,5342,4.5271186440678
"1181",2006-01-06,4,6,-121.5444584,38.48850041,1181,5348,4.52836579170195
"1182",2006-01-06,4,7,-121.5430904,38.50191712,1182,5355,4.53045685279188
"1183",2006-01-06,1,1,-121.4935963,38.61228167,1183,5356,4.52747252747253
"1184",2006-01-06,1,7,-121.5212308,38.61223993,1184,5363,4.52956081081081
"1185",2006-01-06,1,4,-121.519298,38.60769565,1185,5367,4.52911392405063
"1186",2006-01-06,4,7,-121.5080745,38.52101974,1186,5374,4.53119730185497
"1187",2006-01-06,1,6,-121.5187863,38.67056705,1187,5380,4.53243470935131
"1188",2006-01-06,4,7,-121.553597,38.49926989,1188,5387,4.53451178451178
"1189",2006-01-06,1,4,-121.5254515,38.66220298,1189,5391,4.5340622371741
"1190",2006-01-06,1,2,-121.4988152,38.61266409,1190,5393,4.53193277310924
"1191",2006-01-06,5,2,-121.5013123,38.48131474,1191,5395,4.52980688497061
"1192",2006-01-06,2,4,-121.4438554,38.61655961,1192,5399,4.52936241610738
"1193",2006-01-06,3,7,-121.4809362,38.58794604,1193,5406,4.5314333612741
"1194",2006-01-06,1,5,-121.5384257,38.68189146,1194,5411,4.53182579564489
"1195",2006-01-06,4,7,-121.5048812,38.51275183,1195,5418,4.53389121338912
"1196",2006-01-06,2,3,-121.4438778,38.61323987,1196,5421,4.53260869565217
"1197",2006-01-06,6,3,-121.4693534,38.55724607,1197,5424,4.531328320802
"1198",2006-01-06,4,4,-121.5189888,38.52280382,1198,5428,4.53088480801336
"1199",2006-01-06,6,7,-121.4614752,38.54045668,1199,5435,4.53294412010008
"1200",2006-01-06,5,6,-121.4399575,38.47384217,1200,5441,4.53416666666667
"1201",2006-01-06,2,5,-121.4420147,38.64916432,1201,5446,4.5345545378851
"1202",2006-01-06,5,1,-121.4584996,38.4741392,1202,5447,4.53161397670549
"1203",2006-01-06,2,3,-121.4477449,38.66207022,1203,5450,4.53034081463009
"1204",2006-01-06,6,8,-121.4616506,38.54455719,1204,5458,4.53322259136213
"1205",2006-01-06,4,6,-121.5040418,38.50832179,1205,5464,4.5344398340249
"1206",2006-01-06,3,2,-121.496127,38.58102199,1206,5466,4.53233830845771
"1207",2006-01-06,6,6,-121.4599909,38.54718282,1207,5472,4.53355426677713
"1208",2006-01-06,6,7,-121.4717377,38.54222569,1208,5479,4.53559602649007
"1209",2006-01-06,2,7,-121.421018,38.6131004,1209,5486,4.53763440860215
"1210",2006-01-06,5,5,-121.4379135,38.47390639,1210,5491,4.53801652892562
"1211",2006-01-06,2,2,-121.450115,38.60909032,1211,5493,4.53592072667217
"1212",2006-01-06,5,3,-121.4175338,38.46423037,1212,5496,4.53465346534653
"1213",2006-01-06,3,4,-121.4135687,38.5732988,1213,5500,4.53421269579555
"1214",2006-01-06,1,5,-121.4897763,38.63404292,1214,5505,4.53459637561779
"1215",2006-01-06,5,4,-121.4803373,38.48142831,1215,5509,4.53415637860082
"1216",2006-01-06,6,1,-121.4134753,38.5395643,1216,5510,4.53125
"1217",2006-01-06,4,6,-121.4781774,38.52700121,1217,5516,4.53245686113394
"1218",2006-01-06,2,5,-121.449463,38.62464848,1218,5521,4.5328407224959
"1219",2006-01-06,2,6,-121.4488539,38.62419251,1219,5527,4.53404429860541
"1220",2006-01-06,6,3,-121.4260718,38.50569574,1220,5530,4.5327868852459
"1221",2006-01-06,1,7,-121.4861821,38.62609952,1221,5537,4.53480753480753
"1222",2006-01-06,2,6,-121.4388561,38.6180595,1222,5543,4.53600654664484
"1223",2006-01-06,2,7,-121.4318149,38.62979979,1223,5550,4.53802125919869
"1224",2006-01-06,4,8,-121.4766113,38.5546595,1224,5558,4.54084967320261
"1225",2006-01-06,2,3,-121.4605782,38.61103972,1225,5561,4.53959183673469
"1226",2006-01-06,6,7,-121.4563931,38.54118256,1226,5568,4.5415986949429
"1227",2006-01-06,5,6,-121.4667537,38.48863496,1227,5574,4.54278728606357
"1228",2006-01-06,6,3,-121.4143068,38.53196771,1228,5577,4.54153094462541
"1229",2006-01-06,4,8,-121.5194566,38.52289638,1229,5585,4.54434499593165
"1230",2006-01-06,6,2,-121.4410516,38.52328826,1230,5587,4.54227642276423
"1231",2006-01-06,2,4,-121.4441984,38.61970536,1231,5591,4.54183590576767
"1232",2006-01-06,6,1,-121.440543,38.546706,1232,5592,4.53896103896104
"1233",2006-01-06,6,1,-121.4497148,38.53941555,1233,5593,4.53609083536091
"1234",2006-01-06,4,7,-121.4941406,38.53259694,1234,5600,4.53808752025932
"1235",2006-01-06,6,1,-121.4502184,38.54031312,1235,5601,4.53522267206478
"1236",2006-01-06,4,8,-121.493193,38.56216655,1236,5609,4.53802588996764
"1237",2006-01-06,5,2,-121.4043096,38.44093769,1237,5611,4.53597413096201
"1238",2006-01-06,3,2,-121.4765362,38.57586881,1238,5613,4.53392568659128
"1239",2006-01-06,2,7,-121.4231533,38.645494,1239,5620,4.53591606133979
"1240",2006-01-06,3,4,-121.4153398,38.57486746,1240,5624,4.53548387096774
"1241",2006-01-06,1,4,-121.5260796,38.65148271,1241,5628,4.53505237711523
"1242",2006-01-06,2,5,-121.4596922,38.61665653,1242,5633,4.53542673107891
"1243",2006-01-06,1,7,-121.5171426,38.61437028,1243,5640,4.53740949316171
"1244",2006-01-06,3,7,-121.3971144,38.55925109,1244,5647,4.53938906752412
"1245",2006-01-06,2,5,-121.433145,38.62541828,1245,5652,4.53975903614458
"1246",2006-01-06,3,4,-121.4145472,38.5576326,1246,5656,4.53932584269663
"1247",2006-01-06,3,7,-121.4308252,38.55689825,1247,5663,4.54129911788292
"1248",2006-01-06,4,2,-121.4990149,38.52199137,1248,5665,4.53926282051282
"1249",2006-01-06,2,2,-121.44024,38.63259773,1249,5667,4.53722978382706
"1250",2006-01-06,6,7,-121.4186604,38.53481251,1250,5674,4.5392
"1251",2006-01-06,6,7,-121.4351262,38.5149777,1251,5681,4.54116706634692
"1252",2006-01-06,2,7,-121.4613242,38.64384893,1252,5688,4.54313099041534
"1253",2006-01-06,3,4,-121.4910186,38.56987859,1253,5692,4.54269752593775
"1254",2006-01-06,2,6,-121.4518514,38.61357719,1254,5698,4.54385964912281
"1255",2006-01-06,6,5,-121.406008,38.51048773,1255,5703,4.54422310756972
"1256",2006-01-06,3,7,-121.4740683,38.57042066,1256,5710,4.54617834394904
"1257",2006-01-06,1,2,-121.5048798,38.65407136,1257,5712,4.54415274463007
"1258",2006-01-06,2,4,-121.4603742,38.61533617,1258,5716,4.54372019077901
"1259",2006-01-06,4,2,-121.4712477,38.52718667,1259,5718,4.54169976171565
"1260",2006-01-06,4,2,-121.498935,38.52341067,1260,5720,4.53968253968254
"1261",2006-01-06,2,5,-121.4534714,38.61499077,1261,5725,4.54004758128469
"1262",2006-01-06,3,7,-121.492387,38.57763638,1262,5732,4.54199683042789
"1263",2006-01-06,6,1,-121.4671318,38.55128541,1263,5733,4.53919239904988
"1264",2006-01-06,4,2,-121.47576,38.54106323,1264,5735,4.5371835443038
"1265",2006-01-06,4,7,-121.4960849,38.52607558,1265,5742,4.53913043478261
"1266",2006-01-06,6,3,-121.4101636,38.53499467,1266,5745,4.53791469194313
"1267",2006-01-06,3,8,-121.4972354,38.57912112,1267,5753,4.54064719810576
"1268",2006-01-06,3,2,-121.4769139,38.57396483,1268,5755,4.53864353312303
"1269",2006-01-06,2,1,-121.4252477,38.60027317,1269,5756,4.53585500394011
"1270",2006-01-06,6,4,-121.4239591,38.52500301,1270,5760,4.53543307086614
"1271",2006-01-06,6,1,-121.4425904,38.52497346,1271,5761,4.53265145554681
"1272",2006-01-06,5,8,-121.4161718,38.46337225,1272,5769,4.53537735849057
"1273",2006-01-06,6,5,-121.4254625,38.54146972,1273,5774,4.53574234092694
"1274",2006-01-06,3,5,-121.4765615,38.56717253,1274,5779,4.53610675039246
"1275",2006-01-06,6,5,-121.4641052,38.55200185,1275,5784,4.53647058823529
"1276",2006-01-06,4,7,-121.5458973,38.49626332,1276,5791,4.5384012539185
"1277",2006-01-06,4,7,-121.479014,38.53881527,1277,5798,4.54032889584965
"1278",2006-01-06,1,5,-121.5189411,38.68031847,1278,5803,4.54068857589984
"1279",2006-01-06,6,6,-121.4117755,38.51969967,1279,5809,4.54182955433933
"1280",2006-01-06,2,1,-121.4297591,38.63647881,1280,5810,4.5390625
"1281",2006-01-06,3,4,-121.4852542,38.56796664,1281,5814,4.53864168618267
"1282",2006-01-06,2,5,-121.422165,38.60846273,1282,5819,4.5390015600624
"1283",2006-01-06,2,3,-121.4303283,38.63228581,1283,5822,4.53780202650039
"1284",2006-01-06,1,8,-121.5327875,38.66611003,1284,5830,4.5404984423676
"1285",2006-01-06,3,6,-121.4979339,38.58026647,1285,5836,4.54163424124514
"1286",2006-01-06,2,1,-121.423349,38.59664183,1286,5837,4.53888024883359
"1287",2006-01-06,3,8,-121.465448,38.570664,1287,5845,4.54156954156954
"1288",2006-01-06,6,5,-121.44535,38.53331244,1288,5850,4.54192546583851
"1289",2006-01-06,2,3,-121.4578571,38.63980996,1289,5853,4.54072924747867
"1290",2006-01-06,4,3,-121.4866209,38.55982551,1290,5856,4.53953488372093
"1291",2006-01-06,3,4,-121.4670118,38.57203045,1291,5860,4.53911696359411
"1292",2006-01-06,2,6,-121.4558359,38.65829164,1292,5866,4.54024767801858
"1293",2006-01-06,6,6,-121.4316103,38.51496871,1293,5872,4.54137664346481
"1294",2006-01-06,2,4,-121.4330582,38.62488515,1294,5876,4.54095826893354
"1295",2006-01-06,4,7,-121.4905296,38.52815739,1295,5883,4.54285714285714
"1296",2006-01-06,2,6,-121.4558359,38.65829164,1296,5889,4.54398148148148
"1297",2006-01-06,2,6,-121.4558359,38.65829164,1297,5895,4.54510408635312
"1298",2006-01-06,2,7,-121.4447038,38.61278526,1298,5902,4.54699537750385
"1299",2006-01-06,3,3,-121.4641608,38.57858559,1299,5905,4.54580446497306
"1300",2006-01-06,5,7,-121.5013123,38.48131474,1300,5912,4.54769230769231
"1301",2006-01-06,6,7,-121.4232684,38.53564837,1301,5919,4.54957724827056
"1302",2006-01-06,5,6,-121.4722254,38.48005429,1302,5925,4.55069124423963
"1303",2006-01-06,2,7,-121.42747,38.60154457,1303,5932,4.55257099002302
"1304",2006-01-06,3,5,-121.4969049,38.5689405,1304,5937,4.55291411042945
"1305",2006-01-06,2,1,-121.4540173,38.63648582,1305,5938,4.55019157088123
"1306",2006-01-06,2,1,-121.4519681,38.60931329,1306,5939,4.54747320061256
"1307",2006-01-06,4,5,-121.5043061,38.52461457,1307,5944,4.5478194338179
"1308",2006-01-06,1,4,-121.4809634,38.60873292,1308,5948,4.5474006116208
"1309",2006-01-06,2,5,-121.4561105,38.62782124,1309,5953,4.54774637127578
"1310",2006-01-06,2,7,-121.437323,38.6677344,1310,5960,4.54961832061069
"1311",2006-01-06,6,5,-121.4653703,38.54276486,1311,5965,4.54996186117468
"1312",2006-01-06,6,5,-121.4434098,38.51178862,1312,5970,4.55030487804878
"1313",2006-01-06,6,5,-121.4228765,38.50844502,1313,5975,4.55064737242955
"1314",2006-01-06,3,4,-121.409084,38.5695415,1314,5979,4.55022831050228
"1315",2006-01-06,5,6,-121.4561046,38.48728104,1315,5985,4.55133079847909
"1316",2006-01-06,4,1,-121.4763166,38.54049185,1316,5986,4.54863221884498
"1317",2006-01-06,4,5,-121.4990409,38.56211513,1317,5991,4.54897494305239
"1318",2006-01-06,3,5,-121.4192296,38.57227839,1318,5996,4.54931714719272
"1319",2006-01-06,3,4,-121.4116111,38.57400282,1319,6000,4.5489006823351
"1320",2006-01-06,4,1,-121.4947589,38.53118274,1320,6001,4.54621212121212
"1321",2006-01-06,3,5,-121.4656818,38.57167833,1321,6006,4.54655563966692
"1322",2006-01-06,3,7,-121.4986248,38.58052209,1322,6013,4.54841149773071
"1323",2006-01-06,6,8,-121.4673106,38.55450173,1323,6021,4.55102040816327
"1324",2006-01-06,1,6,-121.4959999,38.63020663,1324,6027,4.55211480362538
"1325",2006-01-06,1,4,-121.5057628,38.63431541,1325,6031,4.55169811320755
"1326",2006-01-06,4,7,-121.5355101,38.48541682,1326,6038,4.55354449472097
"1327",2006-01-06,4,5,-121.5188199,38.51416166,1327,6043,4.55388093443858
"1328",2006-01-06,3,1,-121.4921151,38.57995276,1328,6044,4.55120481927711
"1329",2006-01-06,2,5,-121.436147,38.61894976,1329,6049,4.55154251316779
"1330",2006-01-06,1,7,-121.541883,38.65798545,1330,6056,4.55338345864662
"1331",2006-01-06,3,7,-121.4674436,38.57275737,1331,6063,4.55522163786627
"1332",2006-01-06,5,4,-121.4257964,38.44520109,1332,6067,4.5548048048048
"1333",2006-01-06,2,5,-121.4276866,38.62295305,1333,6072,4.55513878469617
"1334",2006-01-06,1,7,-121.5072018,38.61656909,1334,6079,4.55697151424288
"1335",2006-01-06,5,5,-121.505075,38.48126775,1335,6084,4.55730337078652
"1336",2006-01-06,2,2,-121.4203217,38.61953342,1336,6086,4.55538922155689
"1337",2006-01-06,2,2,-121.4483057,38.61496628,1337,6088,4.55347793567689
"1338",2006-01-06,3,5,-121.3793225,38.55863257,1338,6093,4.55381165919283
"1339",2006-01-06,1,2,-121.5055312,38.63589608,1339,6095,4.55190440627334
"1340",2006-01-06,3,6,-121.4974099,38.58314743,1340,6101,4.55298507462687
"1341",2006-01-06,1,2,-121.4855545,38.61896279,1341,6103,4.55108128262491
"1342",2006-01-06,1,3,-121.5049355,38.62034607,1342,6106,4.54992548435171
"1343",2006-01-06,6,1,-121.4601784,38.54828207,1343,6107,4.54728220402085
"1344",2006-01-06,6,4,-121.4679562,38.53826519,1344,6111,4.546875
"1345",2006-01-06,4,6,-121.5074769,38.5012492,1345,6117,4.54795539033457
"1346",2006-01-06,4,7,-121.4739308,38.54115653,1346,6124,4.54977711738484
"1347",2006-01-06,5,7,-121.4269149,38.46639439,1347,6131,4.55159613956941
"1348",2006-01-06,1,7,-121.5213875,38.60504898,1348,6138,4.55341246290801
"1349",2006-01-06,5,7,-121.4961978,38.4773796,1349,6145,4.55522609340252
"1350",2006-01-06,4,5,-121.497206,38.52472122,1350,6150,4.55555555555556
"1351",2006-01-06,3,7,-121.4733278,38.57122734,1351,6157,4.55736491487787
"1352",2006-01-06,3,3,-121.4798987,38.57669401,1352,6160,4.55621301775148
"1353",2006-01-06,5,5,-121.4778424,38.48151866,1353,6165,4.55654101995565
"1354",2006-01-06,6,3,-121.4199387,38.52507079,1354,6168,4.55539143279173
"1355",2006-01-06,4,9,-121.532985,38.47514785,1355,6177,4.55867158671587
"1356",2006-01-06,1,5,-121.4938974,38.61571266,1356,6182,4.55899705014749
"1357",2006-01-06,5,4,-121.4133413,38.45718227,1357,6186,4.55858511422255
"1358",2006-01-06,2,1,-121.423349,38.59664183,1358,6187,4.5559646539028
"1359",2006-01-06,1,3,-121.4982944,38.68319931,1359,6190,4.55481972038263
"1360",2006-01-06,3,1,-121.5046032,38.58203886,1360,6191,4.55220588235294
"1361",2006-01-06,5,4,-121.4896069,38.49536955,1361,6195,4.55180014695077
"1362",2006-01-06,6,4,-121.469478,38.5527076,1362,6199,4.55139500734214
"1363",2006-01-06,5,4,-121.4722254,38.48005429,1363,6203,4.5509904622157
"1364",2006-01-06,5,5,-121.4320063,38.45156394,1364,6208,4.55131964809384
"1365",2006-01-06,3,2,-121.4972354,38.57912112,1365,6210,4.54945054945055
"1366",2006-01-06,5,8,-121.4393847,38.47471535,1366,6218,4.55197657393851
"1367",2006-01-06,1,5,-121.530806,38.6308718,1367,6223,4.55230431602048
"1368",2006-01-06,2,4,-121.4534714,38.61499077,1368,6227,4.55190058479532
"1369",2006-01-06,3,6,-121.5008344,38.58370044,1369,6233,4.55295836376917
"1370",2006-01-06,3,3,-121.4853853,38.58033768,1370,6236,4.55182481751825
"1371",2006-01-06,4,6,-121.476662,38.49958712,1371,6242,4.5528811086798
"1372",2006-01-06,6,5,-121.4164746,38.53533971,1372,6247,4.55320699708455
"1373",2006-01-06,3,2,-121.4898435,38.5703567,1373,6249,4.55134741442098
"1374",2006-01-06,5,5,-121.4197397,38.46009782,1374,6254,4.55167394468705
"1375",2006-01-06,6,3,-121.47265,38.55218939,1375,6257,4.55054545454545
"1376",2006-01-06,3,5,-121.4679847,38.56820709,1376,6262,4.55087209302326
"1377",2006-01-06,3,4,-121.4873108,38.58354799,1377,6266,4.55047204066812
"1378",2006-01-06,2,5,-121.4645843,38.65172566,1378,6271,4.55079825834543
"1379",2006-01-06,2,5,-121.4289938,38.60570671,1379,6276,4.55112400290065
"1380",2006-01-06,1,5,-121.497487,38.62484479,1380,6281,4.55144927536232
"1381",2006-01-06,3,7,-121.5022303,38.59723293,1381,6288,4.55322230267922
"1382",2006-01-06,5,7,-121.4355743,38.4711106,1382,6295,4.55499276410999
"1383",2006-01-06,3,7,-121.411779,38.55575132,1383,6302,4.55676066522054
"1384",2006-01-06,1,4,-121.5229629,38.67087264,1384,6306,4.55635838150289
"1385",2006-01-06,3,7,-121.4097474,38.54812095,1385,6313,4.55812274368231
"1386",2006-01-06,3,2,-121.4910186,38.56987859,1386,6315,4.55627705627706
"1387",2006-01-06,6,7,-121.4673699,38.53296283,1387,6322,4.55803893294881
"1388",2006-01-06,4,7,-121.4802304,38.53549266,1388,6329,4.55979827089337
"1389",2006-01-06,4,8,-121.4802304,38.53549266,1389,6337,4.56227501799856
"1390",2006-01-06,3,8,-121.4976906,38.57905171,1390,6345,4.56474820143885
"1391",2006-01-06,6,8,-121.4673106,38.55450173,1391,6353,4.56721782890007
"1392",2006-01-06,1,1,-121.5028488,38.63449242,1392,6354,4.56465517241379
"1393",2006-01-06,1,5,-121.4958913,38.62130658,1393,6359,4.56496769562096
"1394",2006-01-06,4,4,-121.5395568,38.50583253,1394,6363,4.56456241032999
"1395",2006-01-06,5,1,-121.4189709,38.47433721,1395,6364,4.56200716845878
"1396",2006-01-06,3,7,-121.443663,38.5820092,1396,6371,4.56375358166189
"1397",2006-01-06,2,7,-121.4331176,38.63018236,1397,6378,4.56549749463135
"1398",2006-01-06,5,1,-121.4170901,38.43856722,1398,6379,4.56294706723891
"1399",2006-01-06,2,6,-121.4206076,38.59683958,1399,6385,4.56397426733381
"1400",2006-01-06,1,8,-121.4797863,38.62616159,1400,6393,4.56642857142857
"1401",2006-01-06,4,5,-121.4800469,38.5126813,1401,6398,4.5667380442541
"1402",2006-01-06,5,5,-121.4817969,38.48585582,1402,6403,4.56704707560628
"1403",2006-01-06,6,5,-121.4203339,38.51342719,1403,6408,4.56735566642908
"1404",2006-01-06,3,7,-121.4753542,38.56726042,1404,6415,4.56908831908832
"1405",2006-01-06,3,4,-121.3825223,38.55945974,1405,6419,4.56868327402135
"1406",2006-01-06,1,5,-121.5054717,38.62631527,1406,6424,4.56899004267425
"1407",2006-01-06,3,3,-121.4910186,38.56987859,1407,6427,4.56787491115849
"1408",2006-01-06,6,1,-121.4359118,38.5057826,1408,6428,4.56534090909091
"1409",2006-01-06,5,7,-121.483782,38.49348469,1409,6435,4.56706884315117
"1410",2006-01-07,1,5,-121.5059604,38.62852509,1410,6440,4.56737588652482
"1411",2006-01-07,3,5,-121.418725,38.57495865,1411,6445,4.56768249468462
"1412",2006-01-07,1,7,-121.4764549,38.6265063,1412,6452,4.56940509915014
"1413",2006-01-07,3,7,-121.4100658,38.55783227,1413,6459,4.57112526539278
"1414",2006-01-07,6,7,-121.3794544,38.51411577,1414,6466,4.57284299858557
"1415",2006-01-07,3,7,-121.4679847,38.56820709,1415,6473,4.57455830388693
"1416",2006-01-07,5,5,-121.4784529,38.48354243,1416,6478,4.57485875706215
"1417",2006-01-07,2,7,-121.4509187,38.6242435,1417,6485,4.57657021877205
"1418",2006-01-07,4,5,-121.5340717,38.50026653,1418,6490,4.57686882933709
"1419",2006-01-07,5,4,-121.4263377,38.44736484,1419,6494,4.57646229739253
"1420",2006-01-07,6,2,-121.4211301,38.51651763,1420,6496,4.57464788732394
"1421",2006-01-07,1,5,-121.4963494,38.68378949,1421,6501,4.57494722026742
"1422",2006-01-07,2,4,-121.4529719,38.64634156,1422,6505,4.57454289732771
"1423",2006-01-07,2,1,-121.4569471,38.61449911,1423,6506,4.5720309205903
"1424",2006-01-07,3,3,-121.4926811,38.5923559,1424,6509,4.57092696629214
"1425",2006-01-07,2,2,-121.4495378,38.61359368,1425,6511,4.56912280701754
"1426",2006-01-07,1,7,-121.4952127,38.65733301,1426,6518,4.57082748948107
"1427",2006-01-07,6,6,-121.4731872,38.54431922,1427,6524,4.5718290119131
"1428",2006-01-07,4,7,-121.5191978,38.51253489,1428,6531,4.57352941176471
"1429",2006-01-07,2,7,-121.4432894,38.61060918,1429,6538,4.57522743177047
"1430",2006-01-07,3,3,-121.4391818,38.5606351,1430,6541,4.57412587412587
"1431",2006-01-07,2,6,-121.4329623,38.60086039,1431,6547,4.57512229210342
"1432",2006-01-07,3,7,-121.4732784,38.57223488,1432,6554,4.5768156424581
"1433",2006-01-07,3,3,-121.4776151,38.57851802,1433,6557,4.57571528262387
"1434",2006-01-07,5,9,-121.4285745,38.46501315,1434,6566,4.57880055788006
"1435",2006-01-07,2,6,-121.3815598,38.63862878,1435,6572,4.57979094076655
"1436",2006-01-07,2,5,-121.4522087,38.64268311,1436,6577,4.58008356545961
"1437",2006-01-07,3,7,-121.4833151,38.5797628,1437,6584,4.58176757132916
"1438",2006-01-07,3,7,-121.4802454,38.57520727,1438,6591,4.58344923504868
"1439",2006-01-07,4,8,-121.4873157,38.50741683,1439,6599,4.5858234885337
"1440",2006-01-07,6,4,-121.4674364,38.55451604,1440,6603,4.58541666666667
"1441",2006-01-07,2,7,-121.4458043,38.61483626,1441,6610,4.58709229701596
"1442",2006-01-07,2,7,-121.4600475,38.61040293,1442,6617,4.58876560332871
"1443",2006-01-07,5,5,-121.4591953,38.48467865,1443,6622,4.58905058905059
"1444",2006-01-07,3,3,-121.4818932,38.5857673,1444,6625,4.58795013850416
"1445",2006-01-07,3,4,-121.4853853,38.58033768,1445,6629,4.58754325259516
"1446",2006-01-07,3,7,-121.4156239,38.5696461,1446,6636,4.58921161825726
"1447",2006-01-07,6,2,-121.4417791,38.53396253,1447,6638,4.58742225293711
"1448",2006-01-07,6,5,-121.423683,38.5102751,1448,6643,4.58770718232044
"1449",2006-01-07,5,5,-121.4930712,38.47692109,1449,6648,4.5879917184265
"1450",2006-01-07,6,7,-121.472889,38.54255771,1450,6655,4.58965517241379
"1451",2006-01-07,6,6,-121.4417791,38.53396253,1451,6661,4.59062715368711
"1452",2006-01-07,3,5,-121.4979339,38.58026647,1452,6666,4.59090909090909
"1453",2006-01-07,1,7,-121.4926777,38.62677344,1453,6673,4.59256710254646
"1454",2006-01-07,6,1,-121.4662539,38.54990015,1454,6674,4.59009628610729
"1455",2006-01-07,3,2,-121.4911584,38.59589147,1455,6676,4.58831615120275
"1456",2006-01-07,5,9,-121.5029151,38.47638719,1456,6685,4.59134615384615
"1457",2006-01-07,1,2,-121.5044945,38.628906,1457,6687,4.58956760466712
"1458",2006-01-07,2,5,-121.4306972,38.61063309,1458,6692,4.58984910836763
"1459",2006-01-07,3,8,-121.4731163,38.5780775,1459,6700,4.592186429061
"1460",2006-01-07,6,5,-121.4299421,38.51597101,1460,6705,4.59246575342466
"1461",2006-01-07,3,8,-121.4849513,38.58860652,1461,6713,4.59479808350445
"1462",2006-01-07,2,4,-121.4593596,38.61112465,1462,6717,4.59439124487004
"1463",2006-01-07,2,6,-121.4441687,38.63609026,1463,6723,4.59535201640465
"1464",2006-01-07,6,2,-121.4647667,38.54119139,1464,6725,4.59357923497268
"1465",2006-01-07,2,5,-121.4640355,38.65206911,1465,6730,4.5938566552901
"1466",2006-01-07,6,3,-121.4306788,38.50643521,1466,6733,4.59276944065484
"1467",2006-01-07,4,6,-121.479014,38.53881527,1467,6739,4.59372869802318
"1468",2006-01-07,4,6,-121.479014,38.53881527,1468,6745,4.59468664850136
"1469",2006-01-07,5,5,-121.4803387,38.48267497,1469,6750,4.59496255956433
"1470",2006-01-07,1,7,-121.4745819,38.64316291,1470,6757,4.59659863945578
"1471",2006-01-07,4,2,-121.4990149,38.52199137,1471,6759,4.59483344663494
"1472",2006-01-07,1,6,-121.4960597,38.61035378,1472,6765,4.59578804347826
"1473",2006-01-07,2,2,-121.4671356,38.60134944,1473,6767,4.59402579769179
"1474",2006-01-07,2,4,-121.4392007,38.66146903,1474,6771,4.59362279511533
"1475",2006-01-07,4,6,-121.479014,38.53881527,1475,6777,4.59457627118644
"1476",2006-01-07,4,6,-121.479014,38.53881527,1476,6783,4.59552845528455
"1477",2006-01-07,4,6,-121.479014,38.53881527,1477,6789,4.59647935003385
"1478",2006-01-07,4,5,-121.4857747,38.49574798,1478,6794,4.59675236806495
"1479",2006-01-07,5,4,-121.5033851,38.48164219,1479,6798,4.59634888438134
"1480",2006-01-07,4,7,-121.5122827,38.53690358,1480,6805,4.59797297297297
"1481",2006-01-07,5,6,-121.5033851,38.48164219,1481,6811,4.59891964888589
"1482",2006-01-07,3,1,-121.4267606,38.55614777,1482,6812,4.59649122807018
"1483",2006-01-07,6,5,-121.409083,38.51055016,1483,6817,4.59676331759946
"1484",2006-01-07,3,8,-121.4974099,38.58314743,1484,6825,4.59905660377358
"1485",2006-01-07,6,7,-121.4442877,38.52561869,1485,6832,4.6006734006734
"1486",2006-01-07,3,4,-121.4888437,38.57661853,1486,6836,4.60026917900404
"1487",2006-01-07,6,1,-121.4684935,38.55155803,1487,6837,4.59784801613988
"1488",2006-01-07,4,1,-121.4924032,38.49572235,1488,6838,4.59543010752688
"1489",2006-01-07,5,4,-121.4266738,38.47380451,1489,6842,4.59503022162525
"1490",2006-01-07,6,7,-121.4090938,38.54218087,1490,6849,4.59664429530201
"1491",2006-01-07,2,2,-121.4495674,38.60840673,1491,6851,4.59490274983233
"1492",2006-01-07,5,7,-121.422795,38.47529548,1492,6858,4.59651474530831
"1493",2006-01-07,1,6,-121.5215494,38.61795278,1493,6864,4.5974547890154
"1494",2006-01-07,2,3,-121.42747,38.60154457,1494,6867,4.59638554216868
"1495",2006-01-07,1,7,-121.5015065,38.62718796,1495,6874,4.59799331103679
"1496",2006-01-07,4,5,-121.479014,38.53881527,1496,6879,4.59826203208556
"1497",2006-01-07,4,4,-121.5044528,38.54829616,1497,6883,4.59786239144957
"1498",2006-01-07,2,1,-121.4461612,38.61800953,1498,6884,4.5954606141522
"1499",2006-01-07,5,3,-121.4368769,38.47425283,1499,6887,4.59439626417612
"1500",2006-01-07,4,5,-121.5265412,38.5171811,1500,6892,4.59466666666667
"1501",2006-01-07,3,2,-121.5014996,38.58062786,1501,6894,4.5929380413058
"1502",2006-01-07,6,1,-121.4176103,38.5319734,1502,6895,4.59054593874834
"1503",2006-01-07,6,2,-121.4149241,38.5304331,1503,6897,4.58882235528942
"1504",2006-01-07,4,3,-121.5029821,38.56416411,1504,6900,4.58776595744681
"1505",2006-01-07,5,7,-121.4366375,38.4749354,1505,6907,4.58936877076412
"1506",2006-01-07,4,7,-121.4737109,38.51786994,1506,6914,4.59096945551129
"1507",2006-01-07,1,5,-121.487505,38.62273062,1507,6919,4.59124087591241
"1508",2006-01-07,3,3,-121.415297,38.57411211,1508,6922,4.59018567639257
"1509",2006-01-07,2,8,-121.4484894,38.61475022,1509,6930,4.59244532803181
"1510",2006-01-07,2,5,-121.4477449,38.66207022,1510,6935,4.59271523178808
"1511",2006-01-07,5,3,-121.42717,38.47421612,1511,6938,4.59166115155526
"1512",2006-01-07,2,5,-121.42747,38.60154457,1512,6943,4.59193121693122
"1513",2006-01-07,5,5,-121.4266735,38.47341184,1513,6948,4.59220092531395
"1514",2006-01-07,3,1,-121.4718434,38.5827398,1514,6949,4.58982826948481
"1515",2006-01-07,4,4,-121.4972545,38.56201402,1515,6953,4.58943894389439
"1516",2006-01-07,2,7,-121.4520581,38.59714644,1516,6960,4.5910290237467
"1517",2006-01-07,6,5,-121.4126281,38.5316187,1517,6965,4.59129861568886
"1518",2006-01-07,6,8,-121.4592675,38.54621012,1518,6973,4.5935441370224
"1519",2006-01-07,1,6,-121.5187747,38.60434893,1519,6979,4.59447004608295
"1520",2006-01-07,6,8,-121.4330115,38.53525168,1520,6987,4.59671052631579
"1521",2006-01-07,4,4,-121.5214479,38.5256643,1521,6991,4.59631821170283
"1522",2006-01-07,5,4,-121.4355908,38.47345298,1522,6995,4.59592641261498
"1523",2006-01-07,2,3,-121.4196871,38.62009591,1523,6998,4.59487852921865
"1524",2006-01-07,1,6,-121.4912208,38.61314172,1524,7004,4.59580052493438
"1525",2006-01-07,6,5,-121.4453634,38.54374161,1525,7009,4.59606557377049
"1526",2006-01-07,5,8,-121.4289082,38.45646666,1526,7017,4.59829619921363
"1527",2006-01-07,6,7,-121.4096971,38.5038971,1527,7024,4.59986902423052
"1528",2006-01-07,2,5,-121.4361968,38.63655425,1528,7029,4.60013089005236
"1529",2006-01-07,3,1,-121.4107516,38.54888945,1529,7030,4.59777632439503
"1530",2006-01-07,2,1,-121.4271758,38.60244653,1530,7031,4.59542483660131
"1531",2006-01-07,4,3,-121.483171,38.5248104,1531,7034,4.59438275636839
"1532",2006-01-07,1,5,-121.5038958,38.63747898,1532,7039,4.59464751958225
"1533",2006-01-07,4,7,-121.5514523,38.5074829,1533,7046,4.59621656881931
"1534",2006-01-07,6,7,-121.4623494,38.53580637,1534,7053,4.59778357235984
"1535",2006-01-07,4,7,-121.4743771,38.53942587,1535,7060,4.59934853420195
"1536",2006-01-07,4,4,-121.4747938,38.53078353,1536,7064,4.59895833333333
"1537",2006-01-07,5,9,-121.442412,38.45160088,1537,7073,4.60182173064411
"1538",2006-01-07,1,4,-121.5061358,38.63757642,1538,7077,4.60143042912874
"1539",2006-01-07,6,4,-121.4111584,38.51187331,1539,7081,4.60103963612736
"1540",2006-01-07,1,7,-121.4745819,38.64316291,1540,7088,4.6025974025974
"1541",2006-01-07,2,1,-121.4372107,38.61632706,1541,7089,4.60025957170668
"1542",2006-01-07,5,7,-121.4955741,38.47765971,1542,7096,4.60181582360571
"1543",2006-01-07,1,7,-121.4745819,38.64316291,1543,7103,4.60337005832793
"1544",2006-01-07,3,8,-121.4915244,38.57449124,1544,7111,4.60556994818653
"1545",2006-01-07,6,8,-121.4162179,38.53167806,1545,7119,4.60776699029126
"1546",2006-01-07,2,7,-121.4259738,38.60918188,1546,7126,4.60931435963778
"1547",2006-01-07,4,3,-121.5121112,38.49549964,1547,7129,4.60827407886231
"1548",2006-01-07,2,5,-121.468434,38.63371631,1548,7134,4.60852713178295
"1549",2006-01-07,2,4,-121.4271758,38.60244653,1549,7138,4.60813428018076
"1550",2006-01-07,5,8,-121.4497304,38.47935079,1550,7146,4.61032258064516
"1551",2006-01-07,5,7,-121.4372628,38.48024087,1551,7153,4.61186331399097
"1552",2006-01-07,6,3,-121.4353935,38.50946788,1552,7156,4.61082474226804
"1553",2006-01-07,1,1,-121.5038958,38.63747898,1553,7157,4.6084996780425
"1554",2006-01-07,6,7,-121.4618597,38.55067613,1554,7164,4.61003861003861
"1555",2006-01-07,5,7,-121.4348784,38.47431447,1555,7171,4.61157556270096
"1556",2006-01-07,6,7,-121.4443436,38.52652786,1556,7178,4.61311053984576
"1557",2006-01-07,2,6,-121.3815598,38.63862878,1557,7184,4.61400128452152
"1558",2006-01-07,2,5,-121.4445924,38.61586018,1558,7189,4.61424903722721
"1559",2006-01-07,6,7,-121.4261348,38.53959757,1559,7196,4.61577934573445
"1560",2006-01-07,3,7,-121.4269117,38.55300441,1560,7203,4.61730769230769
"1561",2006-01-07,6,7,-121.4541222,38.55193597,1561,7210,4.61883408071749
"1562",2006-01-07,4,7,-121.5521313,38.50564851,1562,7217,4.62035851472471
"1563",2006-01-07,4,4,-121.5227536,38.51909867,1563,7221,4.61996161228407
"1564",2006-01-07,5,4,-121.4570784,38.48740644,1564,7225,4.6195652173913
"1565",2006-01-07,6,7,-121.4283253,38.51798405,1565,7232,4.62108626198083
"1566",2006-01-07,1,7,-121.5095127,38.65357208,1566,7239,4.62260536398467
"1567",2006-01-07,5,6,-121.4626458,38.48575193,1567,7245,4.62348436502872
"1568",2006-01-07,2,7,-121.4396597,38.59864132,1568,7252,4.625
"1569",2006-01-07,5,1,-121.4575741,38.47963499,1569,7253,4.62268961121734
"1570",2006-01-07,2,5,-121.438918,38.66489459,1570,7258,4.62292993630573
"1571",2006-01-07,6,4,-121.4372604,38.51557848,1571,7262,4.62253341820496
"1572",2006-01-07,3,2,-121.4978345,38.57997771,1572,7264,4.62086513994911
"1573",2006-01-07,5,5,-121.4449453,38.46667459,1573,7269,4.62110616656071
"1574",2006-01-07,2,6,-121.4217991,38.64150838,1574,7275,4.62198221092757
"1575",2006-01-07,4,4,-121.4763166,38.54049185,1575,7279,4.6215873015873
"1576",2006-01-07,4,3,-121.4880316,38.55330191,1576,7282,4.62055837563452
"1577",2006-01-07,6,5,-121.3711111,38.5185631,1577,7287,4.62079898541535
"1578",2006-01-07,2,7,-121.4523028,38.61266767,1578,7294,4.62230671736375
"1579",2006-01-07,3,5,-121.4738686,38.56191557,1579,7299,4.62254591513616
"1580",2006-01-07,1,5,-121.4886144,38.61398148,1580,7304,4.62278481012658
"1581",2006-01-07,6,5,-121.3674672,38.51640138,1581,7309,4.62302340290955
"1582",2006-01-07,6,5,-121.3674672,38.51640138,1582,7314,4.62326169405815
"1583",2006-01-07,6,6,-121.4109836,38.5241743,1583,7320,4.62413139608339
"1584",2006-01-07,2,6,-121.3815598,38.63862878,1584,7326,4.625
"1585",2006-01-07,1,4,-121.5030911,38.68058937,1585,7330,4.62460567823344
"1586",2006-01-07,5,5,-121.478282,38.48542538,1586,7335,4.62484237074401
"1587",2006-01-07,1,4,-121.500722,38.61625577,1587,7339,4.6244486452426
"1588",2006-01-07,1,5,-121.5183447,38.61464988,1588,7344,4.62468513853904
"1589",2006-01-07,6,5,-121.4294935,38.53232093,1589,7349,4.62492133417244
"1590",2006-01-07,5,7,-121.4654193,38.48160193,1590,7356,4.62641509433962
"1591",2006-01-07,4,4,-121.5265412,38.5171811,1591,7360,4.62602137020742
"1592",2006-01-07,3,5,-121.5060581,38.59623882,1592,7365,4.62625628140704
"1593",2006-01-07,5,5,-121.4883531,38.47334706,1593,7370,4.62649089767734
"1594",2006-01-07,4,5,-121.4984736,38.56321928,1594,7375,4.6267252195734
"1595",2006-01-07,2,4,-121.4581238,38.64479784,1595,7379,4.62633228840125
"1596",2006-01-07,3,5,-121.4815537,38.57904372,1596,7384,4.6265664160401
"1597",2006-01-07,5,7,-121.4487485,38.47531506,1597,7391,4.62805259862242
"1598",2006-01-07,3,5,-121.483793,38.58138778,1598,7396,4.62828535669587
"1599",2006-01-07,6,7,-121.4186774,38.51727419,1599,7403,4.62976860537836
"1600",2006-01-07,5,1,-121.4377902,38.4767094,1600,7404,4.6275
"1601",2006-01-07,1,6,-121.5193996,38.60873128,1601,7410,4.62835727670206
"1602",2006-01-07,5,4,-121.4973099,38.47472088,1602,7414,4.62796504369538
"1603",2006-01-07,1,7,-121.5244558,38.65972757,1603,7421,4.62944479101684
"1604",2006-01-07,6,1,-121.4285992,38.53616085,1604,7422,4.62718204488778
"1605",2006-01-07,4,5,-121.4750336,38.5395277,1605,7427,4.62741433021807
"1606",2006-01-07,6,8,-121.4576585,38.54536782,1606,7435,4.62951432129514
"1607",2006-01-07,6,1,-121.4425904,38.52497346,1607,7436,4.62725575606721
"1608",2006-01-07,3,1,-121.4888437,38.57661853,1608,7437,4.625
"1609",2006-01-07,3,5,-121.4733278,38.57122734,1609,7442,4.62523306401492
"1610",2006-01-07,5,1,-121.4368769,38.47425283,1610,7443,4.62298136645963
"1611",2006-01-07,3,7,-121.4986248,38.58052209,1611,7450,4.62445685909373
"1612",2006-01-07,4,7,-121.5446967,38.5048259,1612,7457,4.62593052109181
"1613",2006-01-07,3,8,-121.455336,38.57342047,1613,7465,4.62802231866088
"1614",2006-01-07,2,1,-121.42747,38.60154457,1614,7466,4.62577447335812
"1615",2006-01-07,6,1,-121.4425904,38.52497346,1615,7467,4.62352941176471
"1616",2006-01-07,3,7,-121.4707578,38.57394234,1616,7474,4.625
"1617",2006-01-07,4,4,-121.4767859,38.52273597,1617,7478,4.62461348175634
"1618",2006-01-07,6,1,-121.4367156,38.50622587,1618,7479,4.62237330037083
"1619",2006-01-07,3,7,-121.470553,38.57419952,1619,7486,4.62384187770229
"1620",2006-01-07,6,5,-121.3864319,38.51719277,1620,7491,4.62407407407407
"1621",2006-01-07,6,6,-121.4671236,38.55472055,1621,7497,4.62492288710672
"1622",2006-01-07,3,4,-121.4771418,38.57961426,1622,7501,4.62453760789149
"1623",2006-01-07,4,4,-121.4740915,38.49609085,1623,7505,4.6241528034504
"1624",2006-01-07,3,7,-121.4884229,38.58506592,1624,7512,4.6256157635468
"1625",2006-01-07,4,4,-121.5173512,38.50910577,1625,7516,4.62523076923077
"1626",2006-01-07,3,2,-121.4853853,38.58033768,1626,7518,4.62361623616236
"1627",2006-01-07,3,2,-121.4100717,38.55669548,1627,7520,4.6220036877689
"1628",2006-01-07,3,4,-121.4696858,38.57274295,1628,7524,4.62162162162162
"1629",2006-01-07,2,5,-121.4203421,38.64242648,1629,7529,4.62185389809699
"1630",2006-01-07,2,5,-121.4258885,38.59891162,1630,7534,4.62208588957055
"1631",2006-01-07,4,7,-121.5070696,38.49647503,1631,7541,4.62354383813611
"1632",2006-01-07,5,3,-121.4368769,38.47425283,1632,7544,4.62254901960784
"1633",2006-01-07,3,7,-121.4696858,38.57274295,1633,7551,4.62400489895897
"1634",2006-01-07,6,1,-121.4463754,38.53317181,1634,7552,4.62178702570379
"1635",2006-01-07,2,7,-121.4374397,38.60416364,1635,7559,4.62324159021407
"1636",2006-01-07,5,6,-121.433282,38.45538981,1636,7565,4.62408312958435
"1637",2006-01-07,3,2,-121.5049909,38.58312791,1637,7567,4.62248014660965
"1638",2006-01-07,4,7,-121.5247086,38.49372331,1638,7574,4.62393162393162
"1639",2006-01-07,3,7,-121.4687391,38.57492438,1639,7581,4.62538133007932
"1640",2006-01-07,3,1,-121.5003235,38.57473276,1640,7582,4.62317073170732
"1641",2006-01-07,5,5,-121.4787435,38.48250578,1641,7587,4.62340036563071
"1642",2006-01-07,6,7,-121.4239614,38.5099909,1642,7594,4.62484774665043
"1643",2006-01-07,6,5,-121.4122563,38.51054436,1643,7599,4.62507608034084
"1644",2006-01-07,2,7,-121.4682732,38.62663929,1644,7606,4.62652068126521
"1645",2006-01-07,2,1,-121.4438628,38.62773289,1645,7607,4.62431610942249
"1646",2006-01-07,1,5,-121.494356,38.61915532,1646,7612,4.62454434993925
"1647",2006-01-07,5,1,-121.458006,38.49362212,1647,7613,4.62234365513054
"1648",2006-01-07,5,6,-121.4453528,38.45826571,1648,7619,4.62317961165049
"1649",2006-01-07,3,7,-121.4706693,38.56040719,1649,7626,4.62462098241358
"1650",2006-01-07,3,7,-121.4683488,38.57238808,1650,7633,4.62606060606061
"1651",2006-01-07,6,4,-121.4440747,38.52469228,1651,7637,4.62568140520896
"1652",2006-01-08,2,5,-121.4627865,38.62682816,1652,7642,4.62590799031477
"1653",2006-01-08,3,1,-121.4076334,38.56858948,1653,7643,4.62371445856019
"1654",2006-01-08,6,7,-121.4603243,38.54562468,1654,7650,4.62515114873035
"1655",2006-01-08,2,1,-121.4636228,38.61897041,1655,7651,4.62296072507553
"1656",2006-01-08,6,7,-121.4639789,38.55531288,1656,7658,4.6243961352657
"1657",2006-01-08,6,3,-121.435864,38.5105054,1657,7661,4.62341581170791
"1658",2006-01-08,6,7,-121.4425904,38.52497346,1658,7668,4.6248492159228
"1659",2006-01-08,3,3,-121.4964249,38.57003953,1659,7671,4.62386980108499
"1660",2006-01-08,3,2,-121.4879903,38.57514018,1660,7673,4.62228915662651
"1661",2006-01-08,2,4,-121.4340896,38.59902063,1661,7677,4.62191450933173
"1662",2006-01-08,2,5,-121.4521944,38.60765307,1662,7682,4.62214199759326
"1663",2006-01-08,5,7,-121.4894804,38.47885765,1663,7689,4.62357185808779
"1664",2006-01-08,3,3,-121.4814362,38.56969876,1664,7692,4.62259615384615
"1665",2006-01-08,6,2,-121.4502184,38.54031312,1665,7694,4.62102102102102
"1666",2006-01-08,5,1,-121.4530858,38.48230213,1666,7695,4.61884753901561
"1667",2006-01-08,5,5,-121.5036221,38.4897602,1667,7700,4.61907618476305
"1668",2006-01-08,3,7,-121.4948106,38.58067301,1668,7707,4.6205035971223
"1669",2006-01-08,6,3,-121.4274605,38.51599171,1669,7710,4.619532654284
"1670",2006-01-08,3,2,-121.4853853,38.58033768,1670,7712,4.61796407185629
"1671",2006-01-08,6,4,-121.4186938,38.50795726,1671,7716,4.61759425493716
"1672",2006-01-08,3,3,-121.4853853,38.58033768,1672,7719,4.61662679425837
"1673",2006-01-08,3,8,-121.4683488,38.57238808,1673,7727,4.61864913329349
"1674",2006-01-08,2,7,-121.4598621,38.63488762,1674,7734,4.62007168458781
"1675",2006-01-08,2,7,-121.4576639,38.63392176,1675,7741,4.62149253731343
"1676",2006-01-08,3,6,-121.4910186,38.56987859,1676,7747,4.62231503579952
"1677",2006-01-08,2,6,-121.4212696,38.63297957,1677,7753,4.62313655336911
"1678",2006-01-08,3,2,-121.4641608,38.57858559,1678,7755,4.62157330154946
"1679",2006-01-08,2,9,-121.4553219,38.64628124,1679,7764,4.62418106015485
"1680",2006-01-08,2,1,-121.4258885,38.59891162,1680,7765,4.62202380952381
"1681",2006-01-08,2,5,-121.464145,38.6435627,1681,7770,4.622248661511
"1682",2006-01-08,6,8,-121.4379514,38.5503483,1682,7778,4.62425683709869
"1683",2006-01-08,5,1,-121.4140851,38.44653175,1683,7779,4.62210338680927
"1684",2006-01-08,6,8,-121.4610278,38.54414515,1684,7787,4.62410926365796
"1685",2006-01-08,6,8,-121.4110446,38.50703711,1685,7795,4.62611275964392
"1686",2006-01-08,4,5,-121.5076797,38.49210335,1686,7800,4.62633451957295
"1687",2006-01-08,1,4,-121.5135763,38.67232741,1687,7804,4.62596324836989
"1688",2006-01-08,5,1,-121.428371,38.45814178,1688,7805,4.62381516587678
"1689",2006-01-08,4,5,-121.5164984,38.5194434,1689,7810,4.62403789224393
"1690",2006-01-08,5,5,-121.4327076,38.47672027,1690,7815,4.62426035502959
"1691",2006-01-08,2,5,-121.4624056,38.60075643,1691,7820,4.62448255470136
"1692",2006-01-08,4,8,-121.5343056,38.49494036,1692,7828,4.62647754137116
"1693",2006-01-08,2,7,-121.4244182,38.61199425,1693,7835,4.62787950383934
"1694",2006-01-08,3,4,-121.5025007,38.57652974,1694,7839,4.62750885478158
"1695",2006-01-08,3,7,-121.3940644,38.54818818,1695,7846,4.62890855457227
"1696",2006-01-08,2,7,-121.4407814,38.61535582,1696,7853,4.63030660377358
"1697",2006-01-08,2,7,-121.4637605,38.62578372,1697,7860,4.63170300530348
"1698",2006-01-08,5,5,-121.4641023,38.48719481,1698,7865,4.6319199057715
"1699",2006-01-08,3,7,-121.4007863,38.55093619,1699,7872,4.63331371394938
"1700",2006-01-08,5,3,-121.4451099,38.47920788,1700,7875,4.63235294117647
"1701",2006-01-08,1,7,-121.4941115,38.61562847,1701,7882,4.63374485596708
"1702",2006-01-08,6,8,-121.4650489,38.55158609,1702,7890,4.63572267920094
"1703",2006-01-08,2,2,-121.4499413,38.60938057,1703,7892,4.63417498532002
"1704",2006-01-08,5,7,-121.436643,38.47866168,1704,7899,4.63556338028169
"1705",2006-01-08,2,4,-121.433145,38.63861804,1705,7903,4.63519061583578
"1706",2006-01-08,1,3,-121.5171426,38.61437028,1706,7906,4.63423212192263
"1707",2006-01-08,6,8,-121.4601921,38.55339508,1707,7914,4.63620386643234
"1708",2006-01-08,3,8,-121.493943,38.57920289,1708,7922,4.63817330210773
"1709",2006-01-08,4,7,-121.4960849,38.52607558,1709,7929,4.63955529549444
"1710",2006-01-08,6,4,-121.4318134,38.52545649,1710,7933,4.63918128654971
"1711",2006-01-08,3,1,-121.4770068,38.56892645,1711,7934,4.63705435417884
"1712",2006-01-08,2,5,-121.4424403,38.63952262,1712,7939,4.63726635514019
"1713",2006-01-08,4,3,-121.4899655,38.50924636,1713,7942,4.63631056625803
"1714",2006-01-08,4,1,-121.4854383,38.5594166,1714,7943,4.63418903150525
"1715",2006-01-08,1,1,-121.5097011,38.64960775,1715,7944,4.63206997084548
"1716",2006-01-08,2,7,-121.4473165,38.61164446,1716,7951,4.63344988344988
"1717",2006-01-08,1,8,-121.475208,38.61899876,1717,7959,4.63541059988352
"1718",2006-01-08,2,7,-121.4170313,38.64310734,1718,7966,4.63678696158324
"1719",2006-01-08,2,5,-121.4658894,38.61215173,1719,7971,4.6369982547993
"1720",2006-01-08,2,7,-121.440293,38.63922669,1720,7978,4.63837209302326
"1721",2006-01-08,1,7,-121.4941478,38.66131821,1721,7985,4.63974433468913
"1722",2006-01-08,2,5,-121.4351458,38.62295396,1722,7990,4.63995354239257
"1723",2006-01-08,6,7,-121.4243203,38.54783739,1723,7997,4.64132327336042
"1724",2006-01-08,6,6,-121.4144237,38.5125956,1724,8003,4.64211136890951
"1725",2006-01-08,6,5,-121.4647041,38.53182194,1725,8008,4.64231884057971
"1726",2006-01-08,1,6,-121.5012199,38.62713181,1726,8014,4.64310544611819
"1727",2006-01-08,3,7,-121.444405,38.58286126,1727,8021,4.64447017950203
"1728",2006-01-08,5,4,-121.4133413,38.45718227,1728,8025,4.64409722222222
"1729",2006-01-08,5,3,-121.4939505,38.49136309,1729,8028,4.64314632735685
"1730",2006-01-08,3,5,-121.3850336,38.55495326,1730,8033,4.64335260115607
"1731",2006-01-08,6,7,-121.4453076,38.52573067,1731,8040,4.64471403812825
"1732",2006-01-08,3,7,-121.4732784,38.57223488,1732,8047,4.64607390300231
"1733",2006-01-08,3,4,-121.5048678,38.58121896,1733,8051,4.64570109636469
"1734",2006-01-08,4,6,-121.5074769,38.5012492,1734,8057,4.64648212226067
"1735",2006-01-08,4,4,-121.4785704,38.53684169,1735,8061,4.64610951008645
"1736",2006-01-08,5,6,-121.4834913,38.4853609,1736,8067,4.64688940092166
"1737",2006-01-08,3,7,-121.4110965,38.56345574,1737,8074,4.6482440990213
"1738",2006-01-08,6,5,-121.4569932,38.55100213,1738,8079,4.64844649021864
"1739",2006-01-08,3,7,-121.5052701,38.58221746,1739,8086,4.64979873490512
"1740",2006-01-08,3,7,-121.5074847,38.57206419,1740,8093,4.65114942528736
"1741",2006-01-08,2,4,-121.4280253,38.59513553,1741,8097,4.65077541642734
"1742",2006-01-08,2,5,-121.4421005,38.61227299,1742,8102,4.65097588978186
"1743",2006-01-08,2,2,-121.4427213,38.61209749,1743,8104,4.64945496270798
"1744",2006-01-08,4,6,-121.4781774,38.52700121,1744,8110,4.65022935779816
"1745",2006-01-08,6,6,-121.4144237,38.5125956,1745,8116,4.65100286532951
"1746",2006-01-08,5,7,-121.4425544,38.47363779,1746,8123,4.65234822451317
"1747",2006-01-08,6,8,-121.4359118,38.5057826,1747,8131,4.6542644533486
"1748",2006-01-08,3,3,-121.4680876,38.56613712,1748,8134,4.6533180778032
"1749",2006-01-08,4,4,-121.4772878,38.52484987,1749,8138,4.65294453973699
"1750",2006-01-08,4,7,-121.513869,38.53190991,1750,8145,4.65428571428571
"1751",2006-01-08,4,1,-121.4772878,38.52484987,1751,8146,4.6521987435751
"1752",2006-01-08,5,5,-121.4503108,38.47429277,1752,8151,4.65239726027397
"1753",2006-01-08,2,5,-121.443751,38.65685581,1753,8156,4.65259555048488
"1754",2006-01-08,5,5,-121.4956183,38.48326162,1754,8161,4.65279361459521
"1755",2006-01-08,5,7,-121.4584092,38.47822749,1755,8168,4.65413105413105
"1756",2006-01-08,1,7,-121.4745819,38.64316291,1756,8175,4.65546697038724
"1757",2006-01-08,3,5,-121.4728783,38.5733534,1757,8180,4.65566306203756
"1758",2006-01-08,6,7,-121.4283287,38.53632427,1758,8187,4.65699658703072
"1759",2006-01-08,4,3,-121.4772878,38.52484987,1759,8190,4.6560545764639
"1760",2006-01-08,5,1,-121.4197397,38.46009782,1760,8191,4.65397727272727
"1761",2006-01-08,3,7,-121.4860977,38.57129023,1761,8198,4.65530948324815
"1762",2006-01-08,5,1,-121.4296128,38.44957781,1762,8199,4.65323496027242
"1763",2006-01-08,1,5,-121.5028488,38.63449242,1763,8204,4.65343165059558
"1764",2006-01-08,6,1,-121.4233804,38.51052896,1764,8205,4.65136054421769
"1765",2006-01-08,6,6,-121.4611916,38.54098258,1765,8211,4.65212464589235
"1766",2006-01-08,2,6,-121.3815598,38.63862878,1766,8217,4.65288788221971
"1767",2006-01-08,3,4,-121.4648897,38.57188611,1767,8221,4.65251839275608
"1768",2006-01-08,6,7,-121.4351262,38.5149777,1768,8228,4.65384615384615
"1769",2006-01-08,4,7,-121.4883749,38.56053898,1769,8235,4.6551724137931
"1770",2006-01-08,5,7,-121.4223876,38.47038918,1770,8242,4.65649717514124
"1771",2006-01-08,6,4,-121.4639904,38.53748352,1771,8246,4.65612648221344
"1772",2006-01-08,6,1,-121.4192743,38.53197902,1772,8247,4.65406320541761
"1773",2006-01-08,2,7,-121.4481729,38.62127582,1773,8254,4.65538635081782
"1774",2006-01-08,5,5,-121.42717,38.47421612,1774,8259,4.65558060879369
"1775",2006-01-08,2,5,-121.4432065,38.61495011,1775,8264,4.65577464788732
"1776",2006-01-08,6,7,-121.4284078,38.53255722,1776,8271,4.65709459459459
"1777",2006-01-08,5,1,-121.428371,38.45814178,1777,8272,4.6550365785031
"1778",2006-01-08,6,4,-121.4262572,38.50741014,1778,8276,4.65466816647919
"1779",2006-01-08,6,1,-121.4647521,38.53847284,1779,8277,4.65261382799325
"1780",2006-01-08,2,7,-121.4522932,38.64399332,1780,8284,4.65393258426966
"1781",2006-01-08,2,5,-121.4481729,38.62127582,1781,8289,4.65412689500281
"1782",2006-01-08,2,7,-121.4275537,38.59808509,1782,8296,4.65544332210999
"1783",2006-01-08,6,8,-121.4505653,38.54020494,1783,8304,4.65731912507011
"1784",2006-01-08,6,8,-121.4719831,38.5407138,1784,8312,4.65919282511211
"1785",2006-01-08,3,8,-121.484146,38.57321469,1785,8320,4.66106442577031
"1786",2006-01-08,3,5,-121.405123,38.56931527,1786,8325,4.66125419932811
"1787",2006-01-08,4,1,-121.4727965,38.52904451,1787,8326,4.65920537213206
"1788",2006-01-08,3,7,-121.4648897,38.57188611,1788,8333,4.66051454138703
"1789",2006-01-08,4,4,-121.4966332,38.52466107,1789,8337,4.66014533258804
"1790",2006-01-08,4,7,-121.4787669,38.50801843,1790,8344,4.66145251396648
"1791",2006-01-08,5,7,-121.4276716,38.47047038,1791,8351,4.66275823562256
"1792",2006-01-08,1,7,-121.4988152,38.61266409,1792,8358,4.6640625
"1793",2006-01-08,5,5,-121.4250682,38.47322263,1793,8363,4.66424986056888
"1794",2006-01-08,5,3,-121.4760298,38.49145352,1794,8366,4.66332218506132
"1795",2006-01-08,5,2,-121.4170895,38.46689445,1795,8368,4.66183844011142
"1796",2006-01-08,1,5,-121.5231067,38.6593321,1796,8373,4.66202672605791
"1797",2006-01-08,1,3,-121.5231067,38.6593321,1797,8376,4.66110183639399
"1798",2006-01-08,1,5,-121.5231067,38.6593321,1798,8381,4.66129032258065
"1799",2006-01-08,1,5,-121.5170483,38.60607992,1799,8386,4.66147859922179
"1800",2006-01-08,1,5,-121.4812389,38.62907056,1800,8391,4.66166666666667
"1801",2006-01-08,6,7,-121.4125759,38.5107739,1801,8398,4.66296501943365
"1802",2006-01-08,6,2,-121.4357391,38.50553737,1802,8400,4.661487236404
"1803",2006-01-08,1,5,-121.5246121,38.63001178,1803,8405,4.66167498613422
"1804",2006-01-08,1,5,-121.5219811,38.65588957,1804,8410,4.66186252771619
"1805",2006-01-08,2,7,-121.4588953,38.64648745,1805,8417,4.66315789473684
"1806",2006-01-08,1,5,-121.4988152,38.61266409,1806,8422,4.66334440753045
"1807",2006-01-08,6,1,-121.4485183,38.53725978,1807,8423,4.66131710016602
"1808",2006-01-08,6,1,-121.4148429,38.50238552,1808,8424,4.65929203539823
"1809",2006-01-08,2,5,-121.4569441,38.62592771,1809,8429,4.65948037589829
"1810",2006-01-08,5,5,-121.4544107,38.47577578,1810,8434,4.65966850828729
"1811",2006-01-08,2,1,-121.4269049,38.62613997,1811,8435,4.65764770844837
"1812",2006-01-08,1,4,-121.4978986,38.62504428,1812,8439,4.65728476821192
"1813",2006-01-08,5,3,-121.4663806,38.48712572,1813,8442,4.65637065637066
"1814",2006-01-08,6,5,-121.4310692,38.51357385,1814,8447,4.65656008820287
"1815",2006-01-08,3,7,-121.4063351,38.56824782,1815,8454,4.65785123966942
"1816",2006-01-08,5,7,-121.4416525,38.47371582,1816,8461,4.659140969163
"1817",2006-01-08,2,5,-121.4449174,38.65682845,1817,8466,4.65932856356632
"1818",2006-01-08,1,5,-121.5275004,38.63208305,1818,8471,4.65951595159516
"1819",2006-01-08,4,4,-121.4890727,38.54903932,1819,8475,4.65915338097856
"1820",2006-01-08,4,3,-121.5122674,38.52123795,1820,8478,4.65824175824176
"1821",2006-01-08,5,7,-121.4654193,38.48160193,1821,8485,4.65952773201538
"1822",2006-01-08,3,4,-121.4436294,38.56972093,1822,8489,4.65916575192097
"1823",2006-01-08,4,4,-121.5045145,38.53689529,1823,8493,4.65880416895228
"1824",2006-01-08,4,4,-121.5055033,38.550599,1824,8497,4.65844298245614
"1825",2006-01-08,3,4,-121.4559805,38.57054301,1825,8501,4.65808219178082
"1826",2006-01-08,4,2,-121.4709707,38.52164684,1826,8503,4.6566265060241
"1827",2006-01-08,4,1,-121.4709707,38.52164684,1827,8504,4.65462506841817
"1828",2006-01-08,2,9,-121.4347477,38.63475409,1828,8513,4.65700218818381
"1829",2006-01-08,6,3,-121.4538401,38.54675579,1829,8516,4.65609622744669
"1830",2006-01-08,3,5,-121.4996535,38.56602524,1830,8521,4.65628415300546
"1831",2006-01-08,1,5,-121.4986104,38.68359884,1831,8526,4.65647187329328
"1832",2006-01-08,5,1,-121.4482407,38.48226812,1832,8527,4.65447598253275
"1833",2006-01-08,5,3,-121.475345,38.48146892,1833,8530,4.65357337697763
"1834",2006-01-09,1,7,-121.4966948,38.62648616,1834,8537,4.65485278080698
"1835",2006-01-09,6,7,-121.4236743,38.50962701,1835,8544,4.65613079019074
"1836",2006-01-09,6,2,-121.4723111,38.54837098,1836,8546,4.65468409586057
"1837",2006-01-09,2,7,-121.4599529,38.64969964,1837,8553,4.6559608056614
"1838",2006-01-09,6,4,-121.4305337,38.54653635,1838,8557,4.65560391730141
"1839",2006-01-09,2,5,-121.4256271,38.61442767,1839,8562,4.6557911908646
"1840",2006-01-09,4,4,-121.5124278,38.50337906,1840,8566,4.6554347826087
"1841",2006-01-09,5,7,-121.4301423,38.45936698,1841,8573,4.65670831070071
"1842",2006-01-09,1,7,-121.5429309,38.66058449,1842,8580,4.65798045602606
"1843",2006-01-09,4,7,-121.4875817,38.50102546,1843,8587,4.65925122083559
"1844",2006-01-09,6,6,-121.3929846,38.52466889,1844,8593,4.65997830802603
"1845",2006-01-09,3,7,-121.4551476,38.56831488,1845,8600,4.66124661246612
"1846",2006-01-09,2,5,-121.42747,38.60154457,1846,8605,4.6614301191766
"1847",2006-01-09,2,5,-121.4611073,38.6118742,1847,8610,4.66161342717921
"1848",2006-01-09,6,5,-121.4702374,38.53896764,1848,8615,4.66179653679654
"1849",2006-01-09,3,7,-121.5043919,38.57216632,1849,8622,4.66306111411574
"1850",2006-01-09,2,2,-121.4472415,38.61138598,1850,8624,4.66162162162162
"1851",2006-01-09,3,5,-121.409084,38.5695415,1851,8629,4.66180443003782
"1852",2006-01-09,2,4,-121.4515199,38.65120874,1852,8633,4.66144708423326
"1853",2006-01-09,5,7,-121.4571972,38.48832414,1853,8640,4.66270912034539
"1854",2006-01-09,2,9,-121.4553219,38.64628124,1854,8649,4.66504854368932
"1855",2006-01-09,5,6,-121.4647448,38.4811677,1855,8655,4.66576819407008
"1856",2006-01-09,4,7,-121.5292694,38.51368568,1856,8662,4.66702586206897
"1857",2006-01-09,2,1,-121.4487064,38.61112661,1857,8663,4.66505115778137
"1858",2006-01-09,4,7,-121.5419071,38.51042757,1858,8670,4.66630785791173
"1859",2006-01-09,2,6,-121.4560035,38.64642723,1859,8676,4.6670252824099
"1860",2006-01-09,4,3,-121.5236897,38.51658451,1860,8679,4.66612903225806
"1861",2006-01-09,4,6,-121.479014,38.53881527,1861,8685,4.66684578183772
"1862",2006-01-09,6,1,-121.4715924,38.55806637,1862,8686,4.66487647690655
"1863",2006-01-09,5,7,-121.419142,38.46703933,1863,8693,4.66612989801396
"1864",2006-01-09,6,5,-121.4425904,38.52497346,1864,8698,4.66630901287554
"1865",2006-01-09,6,3,-121.4424934,38.52709836,1865,8701,4.66541554959786
"1866",2006-01-09,3,7,-121.4005189,38.56945352,1866,8708,4.66666666666667
"1867",2006-01-09,4,6,-121.479014,38.53881527,1867,8714,4.6673808248527
"1868",2006-01-09,2,7,-121.4470317,38.61000927,1868,8721,4.6686295503212
"1869",2006-01-09,4,5,-121.5160587,38.4873608,1869,8726,4.66880684858213
"1870",2006-01-09,3,7,-121.4800056,38.57211152,1870,8733,4.67005347593583
"1871",2006-01-09,3,7,-121.4772309,38.57510308,1871,8740,4.67129877071085
"1872",2006-01-09,6,7,-121.4315489,38.50643674,1872,8747,4.67254273504274
"1873",2006-01-09,2,3,-121.4461572,38.62798003,1873,8750,4.67164975974373
"1874",2006-01-09,6,3,-121.3702937,38.52524507,1874,8753,4.67075773745998
"1875",2006-01-09,1,7,-121.4772274,38.62712763,1875,8760,4.672
"1876",2006-01-09,5,5,-121.4616848,38.46956286,1876,8765,4.67217484008529
"1877",2006-01-09,2,5,-121.4134444,38.6347855,1877,8770,4.6723494938732
"1878",2006-01-09,6,5,-121.440543,38.546706,1878,8775,4.67252396166134
"1879",2006-01-09,6,3,-121.4614322,38.55727813,1879,8778,4.67163384779138
"1880",2006-01-09,3,7,-121.5043244,38.5828944,1880,8785,4.67287234042553
"1881",2006-01-09,6,4,-121.4546045,38.55426406,1881,8789,4.67251461988304
"1882",2006-01-09,3,5,-121.409084,38.5695415,1882,8794,4.67268862911796
"1883",2006-01-09,6,7,-121.3865549,38.51141318,1883,8801,4.67392458842273
"1884",2006-01-09,5,7,-121.4933388,38.477606,1884,8808,4.67515923566879
"1885",2006-01-09,6,1,-121.4684935,38.55155803,1885,8809,4.67320954907162
"1886",2006-01-09,3,4,-121.5060865,38.58102646,1886,8813,4.6728525980912
"1887",2006-01-09,3,5,-121.4184859,38.57039642,1887,8818,4.67302596714361
"1888",2006-01-09,5,1,-121.4271773,38.4706931,1888,8819,4.67108050847458
"1889",2006-01-09,4,3,-121.4999731,38.49696354,1889,8822,4.67019587083113
"1890",2006-01-09,3,5,-121.4119685,38.56374026,1890,8827,4.67037037037037
"1891",2006-01-09,5,2,-121.4865622,38.47952023,1891,8829,4.66895822316235
"1892",2006-01-09,2,5,-121.4278895,38.63082118,1892,8834,4.66913319238901
"1893",2006-01-09,2,4,-121.4440379,38.62592964,1893,8838,4.66877971473851
"1894",2006-01-09,4,6,-121.5346969,38.50298477,1894,8844,4.66948257655755
"1895",2006-01-09,6,1,-121.4647218,38.54718283,1895,8845,4.66754617414248
"1896",2006-01-09,6,1,-121.4538401,38.54675579,1896,8846,4.66561181434599
"1897",2006-01-09,1,4,-121.5038958,38.63747898,1897,8850,4.66526093832367
"1898",2006-01-09,6,1,-121.4653678,38.55196925,1898,8851,4.66332982086407
"1899",2006-01-09,3,5,-121.4113652,38.56140588,1899,8856,4.66350710900474
"1900",2006-01-09,3,5,-121.4113652,38.56140588,1900,8861,4.66368421052632
"1901",2006-01-09,6,2,-121.403165,38.53912989,1901,8863,4.66228300894266
"1902",2006-01-09,5,2,-121.4847037,38.49502927,1902,8865,4.6608832807571
"1903",2006-01-09,2,5,-121.4461619,38.61655968,1903,8870,4.66106148187073
"1904",2006-01-09,5,7,-121.4059375,38.44502931,1904,8877,4.66228991596639
"1905",2006-01-09,5,5,-121.4180465,38.44973707,1905,8882,4.66246719160105
"1906",2006-01-09,1,5,-121.5154531,38.67808799,1906,8887,4.66264428121721
"1907",2006-01-09,3,6,-121.4942898,38.58357594,1907,8893,4.66334556895648
"1908",2006-01-09,6,2,-121.4215299,38.52929929,1908,8895,4.66194968553459
"1909",2006-01-09,5,7,-121.4627597,38.49940254,1909,8902,4.66317443687795
"1910",2006-01-09,6,1,-121.4538401,38.54675579,1910,8903,4.66125654450262
"1911",2006-01-09,5,3,-121.4457074,38.46073053,1911,8906,4.6603872318158
"1912",2006-01-09,5,1,-121.4598222,38.48677948,1912,8907,4.65847280334728
"1913",2006-01-09,5,1,-121.4178456,38.44697363,1913,8908,4.65656037637219
"1914",2006-01-09,6,1,-121.4633315,38.54700614,1914,8909,4.6546499477534
"1915",2006-01-09,6,5,-121.4616791,38.54680076,1915,8914,4.65483028720627
"1916",2006-01-09,3,7,-121.4548846,38.57069163,1916,8921,4.65605427974948
"1917",2006-01-09,2,7,-121.4381426,38.62465729,1917,8928,4.65727699530516
"1918",2006-01-09,6,7,-121.4091401,38.53954773,1918,8935,4.6584984358707
"1919",2006-01-09,3,4,-121.5081955,38.57043064,1919,8939,4.65815528921313
"1920",2006-01-09,3,4,-121.4662897,38.57271087,1920,8943,4.6578125
"1921",2006-01-09,6,1,-121.4538401,38.54675579,1921,8944,4.65590838105154
"1922",2006-01-09,5,7,-121.448452,38.47435531,1922,8951,4.65712799167534
"1923",2006-01-09,6,1,-121.4416935,38.54669508,1923,8952,4.65522620904836
"1924",2006-01-09,1,5,-121.4944018,38.60874842,1924,8957,4.65540540540541
"1925",2006-01-09,2,7,-121.439826,38.63895258,1925,8964,4.65662337662338
"1926",2006-01-09,4,7,-121.5389783,38.5077414,1926,8971,4.65784008307373
"1927",2006-01-09,5,7,-121.5022861,38.47692818,1927,8978,4.65905552672548
"1928",2006-01-09,4,5,-121.5225871,38.51995472,1928,8983,4.65923236514523
"1929",2006-01-09,3,4,-121.4732784,38.57223488,1929,8987,4.65889061689995
"1930",2006-01-09,5,1,-121.4408522,38.44878699,1930,8988,4.65699481865285
"1931",2006-01-09,3,4,-121.4926364,38.57798346,1931,8992,4.65665458311756
"1932",2006-01-09,3,4,-121.4745346,38.56931341,1932,8996,4.65631469979296
"1933",2006-01-09,6,1,-121.458959,38.5467716,1933,8997,4.65442317640973
"1934",2006-01-09,3,1,-121.485061,38.59279731,1934,8998,4.65253360910031
"1935",2006-01-09,4,4,-121.4831624,38.55689118,1935,9002,4.65219638242894
"1936",2006-01-09,1,1,-121.5195671,38.61866401,1936,9003,4.65030991735537
"1937",2006-01-09,2,1,-121.4568936,38.64404243,1937,9004,4.64842540010325
"1938",2006-01-09,1,6,-121.4959999,38.63020663,1938,9010,4.64912280701754
"1939",2006-01-09,6,4,-121.440535,38.52498825,1939,9014,4.64878803506962
"1940",2006-01-09,5,4,-121.4323938,38.4616929,1940,9018,4.64845360824742
"1941",2006-01-09,3,1,-121.485061,38.59279731,1941,9019,4.64657393096342
"1942",2006-01-09,3,3,-121.4602865,38.56588957,1942,9022,4.64572605561277
"1943",2006-01-09,3,5,-121.3940644,38.54818818,1943,9027,4.64590838908904
"1944",2006-01-09,4,8,-121.5113897,38.52691284,1944,9035,4.64763374485597
"1945",2006-01-09,1,6,-121.5183604,38.67811932,1945,9041,4.64832904884319
"1946",2006-01-09,2,4,-121.4265596,38.61118933,1946,9045,4.64799588900308
"1947",2006-01-09,3,3,-121.4745537,38.5752667,1947,9048,4.64714946070878
"1948",2006-01-09,5,6,-121.43386,38.47059147,1948,9054,4.64784394250513
"1949",2006-01-09,6,3,-121.4421196,38.52394421,1949,9057,4.6469984607491
"1950",2006-01-09,2,4,-121.4469922,38.65887585,1950,9061,4.64666666666667
"1951",2006-01-09,5,6,-121.49092,38.47732902,1951,9067,4.6473603280369
"1952",2006-01-09,3,4,-121.4648897,38.57188611,1952,9071,4.64702868852459
"1953",2006-01-09,6,1,-121.4460953,38.54674644,1953,9072,4.64516129032258
"1954",2006-01-09,1,7,-121.5028488,38.63449242,1954,9079,4.64636642784033
"1955",2006-01-09,3,2,-121.4648897,38.57188611,1955,9081,4.64501278772379
"1956",2006-01-09,4,6,-121.4757666,38.503518,1956,9087,4.64570552147239
"1957",2006-01-09,2,4,-121.446158,38.62427027,1957,9091,4.64537557485948
"1958",2006-01-09,5,1,-121.4501724,38.48274139,1958,9092,4.64351378958121
"1959",2006-01-09,5,3,-121.42717,38.47421612,1959,9095,4.64267483409903
"1960",2006-01-09,3,3,-121.4876958,38.57815667,1960,9098,4.64183673469388
"1961",2006-01-09,5,3,-121.4401567,38.44752323,1961,9101,4.64099949005609
"1962",2006-01-09,4,5,-121.5250509,38.51685646,1962,9106,4.64118246687054
"1963",2006-01-09,4,6,-121.4920577,38.55019478,1963,9112,4.64187468160978
"1964",2006-01-09,4,1,-121.479149,38.53085814,1964,9113,4.64002036659878
"1965",2006-01-09,4,7,-121.5079025,38.49525938,1965,9120,4.6412213740458
"1966",2006-01-09,6,1,-121.4520421,38.5473157,1966,9121,4.63936927772126
"1967",2006-01-09,6,1,-121.4538401,38.54675579,1967,9122,4.63751906456533
"1968",2006-01-09,3,3,-121.4682622,38.57602331,1968,9125,4.63668699186992
"1969",2006-01-09,4,5,-121.5072531,38.56559378,1969,9130,4.63687150837989
"1970",2006-01-09,4,1,-121.5096362,38.54910632,1970,9131,4.63502538071066
"1971",2006-01-09,3,1,-121.5014996,38.58062786,1971,9132,4.63318112633181
"1972",2006-01-09,3,3,-121.4162358,38.57009677,1972,9135,4.63235294117647
"1973",2006-01-09,5,1,-121.4341184,38.4511981,1973,9136,4.63051191079574
"1974",2006-01-09,2,5,-121.4490547,38.61315477,1974,9141,4.6306990881459
"1975",2006-01-09,3,7,-121.413324,38.56689949,1975,9148,4.63189873417722
"1976",2006-01-09,2,7,-121.42747,38.60154457,1976,9155,4.6330971659919
"1977",2006-01-09,5,1,-121.471758,38.48278711,1977,9156,4.63125948406677
"1978",2006-01-09,5,1,-121.4462157,38.47985848,1978,9157,4.62942366026289
"1979",2006-01-09,6,5,-121.422371,38.50440869,1979,9162,4.62961091460333
"1980",2006-01-09,6,4,-121.4662305,38.55630084,1980,9166,4.62929292929293
"1981",2006-01-09,1,6,-121.5161468,38.65847399,1981,9172,4.62998485613327
"1982",2006-01-09,3,4,-121.4906436,38.57929276,1982,9176,4.62966700302725
"1983",2006-01-09,1,6,-121.5161468,38.65847399,1983,9182,4.63035804336863
"1984",2006-01-09,4,4,-121.5390906,38.50388656,1984,9186,4.63004032258065
"1985",2006-01-09,4,3,-121.5067911,38.56665175,1985,9189,4.62921914357683
"1986",2006-01-09,2,1,-121.4487064,38.61112661,1986,9190,4.62739174219537
"1987",2006-01-09,6,1,-121.4712461,38.54392319,1987,9191,4.62556618017111
"1988",2006-01-09,5,7,-121.4223876,38.47038918,1988,9198,4.62676056338028
"1989",2006-01-09,2,2,-121.4444846,38.61755666,1989,9200,4.62543991955757
"1990",2006-01-09,5,5,-121.4644874,38.48149327,1990,9205,4.62562814070352
"1991",2006-01-09,4,8,-121.5196666,38.47765523,1991,9213,4.6273229532898
"1992",2006-01-09,1,3,-121.5007778,38.61728024,1992,9216,4.62650602409639
"1993",2006-01-09,1,1,-121.4755286,38.6296517,1993,9217,4.62468640240843
"1994",2006-01-09,4,4,-121.5018595,38.52007051,1994,9221,4.62437311935807
"1995",2006-01-09,2,5,-121.4473381,38.61112009,1995,9226,4.62456140350877
"1996",2006-01-09,3,5,-121.4940462,38.57551005,1996,9231,4.624749498998
"1997",2006-01-09,5,1,-121.4503108,38.47429277,1997,9232,4.6229344016024
"1998",2006-01-09,2,5,-121.4253528,38.62197217,1998,9237,4.62312312312312
"1999",2006-01-09,6,7,-121.4641035,38.55595051,1999,9244,4.62431215607804
"2000",2006-01-09,2,3,-121.4251692,38.62477487,2000,9247,4.6235
"2001",2006-01-09,3,4,-121.5052755,38.58245363,2001,9251,4.6231884057971
"2002",2006-01-09,2,3,-121.4322662,38.62192663,2002,9254,4.62237762237762
"2003",2006-01-09,3,2,-121.4836896,38.58601422,2003,9256,4.62106839740389
"2004",2006-01-09,4,5,-121.5203336,38.48340799,2004,9261,4.62125748502994
"2005",2006-01-09,4,5,-121.5431042,38.51177507,2005,9266,4.6214463840399
"2006",2006-01-09,3,4,-121.4693599,38.56342448,2006,9270,4.62113659022931
"2007",2006-01-09,3,6,-121.4817665,38.591168,2007,9276,4.62182361733931
"2008",2006-01-09,2,5,-121.4476543,38.61140992,2008,9281,4.62201195219123
"2009",2006-01-09,5,5,-121.4601374,38.48020167,2009,9286,4.62220009955202
"2010",2006-01-09,2,1,-121.4322662,38.62192663,2010,9287,4.62039800995025
"2011",2006-01-09,1,4,-121.5055312,38.63589608,2011,9291,4.62008950770761
"2012",2006-01-09,2,1,-121.4581841,38.60785424,2012,9292,4.6182902584493
"2013",2006-01-09,5,5,-121.4684313,38.48151147,2013,9297,4.61847988077496
"2014",2006-01-09,4,5,-121.506385,38.56215492,2014,9302,4.61866931479643
"2015",2006-01-09,4,6,-121.515754,38.53385644,2015,9308,4.61935483870968
"2016",2006-01-09,6,4,-121.4274605,38.51599171,2016,9312,4.61904761904762
"2017",2006-01-09,3,3,-121.4920473,38.58358534,2017,9315,4.61824491819534
"2018",2006-01-09,2,2,-121.4257137,38.64278274,2018,9317,4.61694747274529
"2019",2006-01-09,4,5,-121.4790449,38.55805348,2019,9322,4.617137196632
"2020",2006-01-09,4,4,-121.4827348,38.49575914,2020,9326,4.61683168316832
"2021",2006-01-09,1,2,-121.5000769,38.61890556,2021,9328,4.61553686293914
"2022",2006-01-09,4,5,-121.5321939,38.48340441,2022,9333,4.61572700296736
"2023",2006-01-09,5,6,-121.4790738,38.48272145,2023,9339,4.61641127039051
"2024",2006-01-09,3,5,-121.4906793,38.57772224,2024,9344,4.61660079051383
"2025",2006-01-09,4,2,-121.4790156,38.5543985,2025,9346,4.61530864197531
"2026",2006-01-09,3,1,-121.4973304,38.58003319,2026,9347,4.61352418558736
"2027",2006-01-09,1,3,-121.5043183,38.65877823,2027,9350,4.61272816970893
"2028",2006-01-09,3,5,-121.4740683,38.57042066,2028,9355,4.6129191321499
"2029",2006-01-09,6,1,-121.4711067,38.55234985,2029,9356,4.61113849186791
"2030",2006-01-09,4,3,-121.4900812,38.51018598,2030,9359,4.61034482758621
"2031",2006-01-09,6,7,-121.464715,38.54528535,2031,9366,4.61152141802068
"2032",2006-01-09,1,5,-121.4962856,38.61949324,2032,9371,4.6117125984252
"2033",2006-01-09,4,4,-121.534651,38.48214296,2033,9375,4.61141170683719
"2034",2006-01-09,2,3,-121.455557,38.61138144,2034,9378,4.61061946902655
"2035",2006-01-09,6,1,-121.4715398,38.55477924,2035,9379,4.60884520884521
"2036",2006-01-09,4,7,-121.5212433,38.49466185,2036,9386,4.61001964636542
"2037",2006-01-09,2,4,-121.4487064,38.61112661,2037,9390,4.60972017673049
"2038",2006-01-09,2,5,-121.4535138,38.61950804,2038,9395,4.6099116781158
"2039",2006-01-09,6,1,-121.4494106,38.524921,2039,9396,4.60814124570868
"2040",2006-01-09,6,1,-121.4439667,38.54215599,2040,9397,4.60637254901961
"2041",2006-01-09,3,5,-121.4666533,38.56944762,2041,9402,4.60656540911318
"2042",2006-01-09,3,7,-121.43864,38.55792771,2042,9409,4.6077375122429
"2043",2006-01-09,1,5,-121.4869215,38.6259957,2043,9414,4.6079295154185
"2044",2006-01-09,6,6,-121.4243203,38.54783739,2044,9420,4.60861056751468
"2045",2006-01-09,6,1,-121.4671318,38.55128541,2045,9421,4.60684596577017
"2046",2006-01-09,2,2,-121.4262601,38.59577758,2046,9423,4.60557184750733
"2047",2006-01-09,3,5,-121.411779,38.55575132,2047,9428,4.60576453346361
"2048",2006-01-09,1,5,-121.4746566,38.61972393,2048,9433,4.60595703125
"2049",2006-01-09,1,4,-121.4978994,38.62741952,2049,9437,4.60566129819424
"2050",2006-01-09,3,4,-121.4260374,38.57562396,2050,9441,4.60536585365854
"2051",2006-01-09,5,4,-121.4549077,38.48617977,2051,9445,4.60507069722087
"2052",2006-01-09,1,4,-121.4745819,38.64316291,2052,9449,4.60477582846004
"2053",2006-01-09,2,7,-121.4520581,38.59714644,2053,9456,4.60594252313687
"2054",2006-01-09,2,5,-121.4534502,38.6474367,2054,9461,4.60613437195716
"2055",2006-01-09,1,7,-121.4745819,38.64316291,2055,9468,4.60729927007299
"2056",2006-01-09,4,4,-121.4990149,38.52199137,2056,9472,4.60700389105058
"2057",2006-01-09,1,5,-121.5198701,38.61732525,2057,9477,4.60719494409334
"2058",2006-01-09,1,4,-121.5066925,38.62896755,2058,9481,4.60689990281827
"2059",2006-01-09,6,1,-121.4647075,38.54395353,2059,9482,4.60514813016027
"2060",2006-01-09,2,5,-121.4485,38.60930781,2060,9487,4.60533980582524
"2061",2006-01-09,4,1,-121.4787544,38.50686233,2061,9488,4.60359049005337
"2062",2006-01-09,6,3,-121.4538401,38.54675579,2062,9491,4.60281280310378
"2063",2006-01-09,2,6,-121.4278524,38.62147929,2063,9497,4.60349006301503
"2064",2006-01-09,6,3,-121.4473287,38.525636,2064,9500,4.60271317829457
"2065",2006-01-09,5,2,-121.4270863,38.47245555,2065,9502,4.60145278450363
"2066",2006-01-09,3,7,-121.4747124,38.5793726,2066,9509,4.6026137463698
"2067",2006-01-09,2,7,-121.4389474,38.62247542,2067,9516,4.60377358490566
"2068",2006-01-09,1,7,-121.5028488,38.63449242,2068,9523,4.60493230174081
"2069",2006-01-09,1,7,-121.5168735,38.67732505,2069,9530,4.60608989850169
"2070",2006-01-09,4,5,-121.4800628,38.51434816,2070,9535,4.60628019323671
"2071",2006-01-09,1,5,-121.4919849,38.61542969,2071,9540,4.60647030420087
"2072",2006-01-09,2,1,-121.4216347,38.64191945,2072,9541,4.60472972972973
"2073",2006-01-09,2,3,-121.426719,38.62009248,2073,9544,4.60395561987458
"2074",2006-01-09,3,3,-121.4856685,38.59007055,2074,9547,4.60318225650916
"2075",2006-01-09,4,7,-121.5374388,38.48538062,2075,9554,4.60433734939759
"2076",2006-01-09,6,7,-121.458819,38.55462435,2076,9561,4.60549132947977
"2077",2006-01-09,2,1,-121.4461725,38.61474191,2077,9562,4.60375541646606
"2078",2006-01-09,6,3,-121.4374105,38.54221766,2078,9565,4.60298363811357
"2079",2006-01-09,1,5,-121.5005071,38.61295423,2079,9570,4.6031746031746
"2080",2006-01-09,2,8,-121.420291,38.60307405,2080,9578,4.60480769230769
"2081",2006-01-09,5,5,-121.4189709,38.47433721,2081,9583,4.60499759730899
"2082",2006-01-09,5,5,-121.4381169,38.45471595,2082,9588,4.60518731988473
"2083",2006-01-09,6,7,-121.43427,38.52555366,2083,9595,4.60633701392223
"2084",2006-01-09,2,1,-121.4278524,38.62147929,2084,9596,4.60460652591171
"2085",2006-01-09,5,7,-121.4598152,38.47614715,2085,9603,4.60575539568345
"2086",2006-01-09,2,5,-121.4448995,38.62406654,2086,9608,4.60594439117929
"2087",2006-01-09,3,7,-121.4274073,38.55269382,2087,9615,4.60709151892669
"2088",2006-01-09,1,3,-121.5000765,38.61696967,2088,9618,4.60632183908046
"2089",2006-01-09,5,5,-121.4395992,38.47587793,2089,9623,4.60651029200574
"2090",2006-01-09,2,5,-121.4408906,38.63936687,2090,9628,4.6066985645933
"2091",2006-01-09,6,2,-121.4681974,38.53450711,2091,9630,4.60545193687231
"2092",2006-01-09,2,5,-121.4534085,38.627317,2092,9635,4.60564053537285
"2093",2006-01-09,3,8,-121.4974099,38.58314743,2093,9643,4.60726230291448
"2094",2006-01-09,6,1,-121.4629583,38.53944483,2094,9644,4.60553963705826
"2095",2006-01-10,3,7,-121.4787306,38.56374165,2095,9651,4.60668257756563
"2096",2006-01-10,3,7,-121.4688872,38.58276198,2096,9658,4.60782442748092
"2097",2006-01-10,6,1,-121.4448282,38.52983357,2097,9659,4.60610395803529
"2098",2006-01-10,3,7,-121.5003415,38.57615249,2098,9666,4.60724499523356
"2099",2006-01-10,4,6,-121.4830904,38.52532078,2099,9672,4.60790852787041
"2100",2006-01-10,1,7,-121.5270363,38.66298106,2100,9679,4.60904761904762
"2101",2006-01-10,2,7,-121.4244182,38.61199425,2101,9686,4.61018562589243
"2102",2006-01-10,5,2,-121.491965,38.4890423,2102,9688,4.60894386298763
"2103",2006-01-10,3,7,-121.4841051,38.57500761,2103,9695,4.61008083689967
"2104",2006-01-10,1,7,-121.4966948,38.62648616,2104,9702,4.61121673003802
"2105",2006-01-10,6,7,-121.4417342,38.54327657,2105,9709,4.61235154394299
"2106",2006-01-10,5,4,-121.4370462,38.45543018,2106,9713,4.61206077872745
"2107",2006-01-10,3,3,-121.4870224,38.58618556,2107,9716,4.61129568106312
"2108",2006-01-10,5,5,-121.4546419,38.47431603,2108,9721,4.61148007590133
"2109",2006-01-10,6,2,-121.4647218,38.54718283,2109,9723,4.61024182076814
"2110",2006-01-10,1,7,-121.541883,38.65798545,2110,9730,4.61137440758294
"2111",2006-01-10,3,2,-121.4642474,38.57498057,2111,9732,4.61013737565135
"2112",2006-01-10,3,7,-121.4884229,38.58506592,2112,9739,4.61126893939394
"2113",2006-01-10,2,6,-121.3815598,38.63862878,2113,9745,4.6119261713204
"2114",2006-01-10,2,5,-121.4426884,38.62346829,2114,9750,4.61210974456008
"2115",2006-01-10,3,4,-121.4935219,38.57100991,2115,9754,4.61182033096927
"2116",2006-01-10,1,1,-121.4755625,38.61124309,2116,9755,4.61011342155009
"2117",2006-01-10,6,5,-121.406008,38.51048773,2117,9760,4.61029759093056
"2118",2006-01-10,3,7,-121.417918,38.56412181,2118,9767,4.61142587346553
"2119",2006-01-10,6,9,-121.4517155,38.54066622,2119,9776,4.61349693251534
"2120",2006-01-10,1,8,-121.5324558,38.64674718,2120,9784,4.61509433962264
"2121",2006-01-10,4,5,-121.5139178,38.50111994,2121,9789,4.61527581329562
"2122",2006-01-10,1,5,-121.5191764,38.62210853,2122,9794,4.61545711592837
"2123",2006-01-10,6,7,-121.4304905,38.51995809,2123,9801,4.61658031088083
"2124",2006-01-10,6,5,-121.4304905,38.51995809,2124,9806,4.61676082862524
"2125",2006-01-10,4,3,-121.4990149,38.52199137,2125,9809,4.616
"2126",2006-01-10,5,6,-121.4891676,38.47764806,2126,9815,4.61665098777046
"2127",2006-01-10,2,5,-121.4286169,38.5985901,2127,9820,4.61683121767748
"2128",2006-01-10,2,5,-121.4655275,38.61188095,2128,9825,4.61701127819549
"2129",2006-01-10,3,1,-121.4775255,38.58215599,2129,9826,4.61531235321747
"2130",2006-01-10,3,7,-121.4248243,38.57294064,2130,9833,4.61643192488263
"2131",2006-01-10,2,5,-121.4646484,38.60590997,2131,9838,4.61661191928672
"2132",2006-01-10,3,7,-121.4442104,38.56519016,2132,9845,4.61772983114447
"2133",2006-01-10,4,1,-121.4827938,38.50305262,2133,9846,4.61603375527426
"2134",2006-01-10,4,4,-121.4990149,38.52199137,2134,9850,4.61574507966261
"2135",2006-01-10,2,1,-121.4316422,38.62599581,2135,9851,4.61405152224824
"2136",2006-01-10,2,2,-121.4504318,38.6161187,2136,9853,4.61282771535581
"2137",2006-01-10,3,7,-121.4802163,38.57871645,2137,9860,4.61394478240524
"2138",2006-01-10,2,1,-121.434294,38.62354293,2138,9861,4.61225444340505
"2139",2006-01-10,5,3,-121.4803322,38.47732859,2139,9864,4.61150070126227
"2140",2006-01-10,1,7,-121.4784703,38.62996703,2140,9871,4.61261682242991
"2141",2006-01-10,4,4,-121.5169435,38.50634715,2141,9875,4.61233068659505
"2142",2006-01-10,1,7,-121.5027381,38.67745476,2142,9882,4.61344537815126
"2143",2006-01-10,2,1,-121.433145,38.62541828,2143,9883,4.61175921605226
"2144",2006-01-10,2,1,-121.429178,38.63647046,2144,9884,4.61007462686567
"2145",2006-01-10,1,4,-121.5129034,38.64420903,2145,9888,4.60979020979021
"2146",2006-01-10,3,6,-121.4714654,38.58088731,2146,9894,4.61043802423113
"2147",2006-01-10,2,1,-121.433145,38.62541828,2147,9895,4.60875640428505
"2148",2006-01-10,3,2,-121.4979339,38.58026647,2148,9897,4.60754189944134
"2149",2006-01-10,1,7,-121.5277369,38.66719342,2149,9904,4.60865518845975
"2150",2006-01-10,4,1,-121.4827604,38.49850245,2150,9905,4.60697674418605
"2151",2006-01-10,2,1,-121.4392211,38.6183743,2151,9906,4.60529986052999
"2152",2006-01-10,6,5,-121.3905289,38.51055822,2152,9911,4.60548327137546
"2153",2006-01-10,1,5,-121.4951282,38.66234122,2153,9916,4.60566651184394
"2154",2006-01-10,4,7,-121.5277277,38.50635324,2154,9923,4.60677808727948
"2155",2006-01-10,5,1,-121.4769699,38.48664963,2155,9924,4.60510440835267
"2156",2006-01-10,2,6,-121.456513,38.60992783,2156,9930,4.60575139146568
"2157",2006-01-10,3,8,-121.4646165,38.56587673,2157,9938,4.60732498840983
"2158",2006-01-10,1,5,-121.4866655,38.62363032,2158,9943,4.60750695088044
"2159",2006-01-10,1,7,-121.5000769,38.61890556,2159,9950,4.60861509958314
"2160",2006-01-10,6,7,-121.4284607,38.5425445,2160,9957,4.60972222222222
"2161",2006-01-10,2,1,-121.4290136,38.62595817,2161,9958,4.60805182785747
"2162",2006-01-10,6,4,-121.4711067,38.55234985,2162,9962,4.60777058279371
"2163",2006-01-10,3,1,-121.4406785,38.56913281,2163,9963,4.60610263522885
"2164",2006-01-10,6,6,-121.4254625,38.54146972,2164,9969,4.60674676524954
"2165",2006-01-10,5,2,-121.4465943,38.47427504,2165,9971,4.60554272517321
"2166",2006-01-10,6,5,-121.4448282,38.52983357,2166,9976,4.60572483841182
"2167",2006-01-10,2,1,-121.4650379,38.64681802,2167,9977,4.60406091370558
"2168",2006-01-10,1,1,-121.4902491,38.61589986,2168,9978,4.60239852398524
"2169",2006-01-10,6,2,-121.416555,38.53876157,2169,9980,4.60119870908253
"2170",2006-01-10,6,3,-121.4134753,38.5395643,2170,9983,4.60046082949309
"2171",2006-01-10,6,5,-121.427517,38.52507559,2171,9988,4.60064486411792
"2172",2006-01-10,1,6,-121.5556894,38.65550746,2172,9994,4.60128913443831
"2173",2006-01-10,3,4,-121.4827568,38.57715166,2173,9998,4.60101242521859
"2174",2006-01-10,2,5,-121.4527905,38.61341962,2174,10003,4.60119595216191
"2175",2006-01-10,2,1,-121.433145,38.62541828,2175,10004,4.59954022988506
"2176",2006-01-10,3,7,-121.3802811,38.5545627,2176,10011,4.60064338235294
"2177",2006-01-10,4,5,-121.5298585,38.51446243,2177,10016,4.60082682590721
"2178",2006-01-10,6,5,-121.4056953,38.53630908,2178,10021,4.6010101010101
"2179",2006-01-10,2,1,-121.4318753,38.62529673,2179,10022,4.59935750344195
"2180",2006-01-10,3,1,-121.491401,38.56382548,2180,10023,4.59770642201835
"2181",2006-01-10,2,1,-121.4301867,38.63466859,2181,10024,4.59605685465383
"2182",2006-01-10,2,5,-121.468398,38.62868558,2182,10029,4.59624197983501
"2183",2006-01-10,5,7,-121.4376744,38.47943831,2183,10036,4.59734310581768
"2184",2006-01-10,4,5,-121.4919171,38.52475578,2184,10041,4.59752747252747
"2185",2006-01-10,5,6,-121.4673944,38.49407763,2185,10047,4.59816933638444
"2186",2006-01-10,5,6,-121.4174193,38.46499591,2186,10053,4.59881061299177
"2187",2006-01-10,6,2,-121.471396,38.55766731,2187,10055,4.5976223136717
"2188",2006-01-10,2,1,-121.4366726,38.62020172,2188,10056,4.59597806215722
"2189",2006-01-10,2,3,-121.4341446,38.6220841,2189,10059,4.59524897213339
"2190",2006-01-10,3,2,-121.4841374,38.59278496,2190,10061,4.59406392694064
"2191",2006-01-10,1,1,-121.4719599,38.61142717,2191,10062,4.59242355089
"2192",2006-01-10,2,1,-121.442601,38.61449687,2192,10063,4.59078467153285
"2193",2006-01-10,2,2,-121.4487064,38.61112661,2193,10065,4.58960328317373
"2194",2006-01-10,1,6,-121.4959999,38.63020663,2194,10071,4.59024612579763
"2195",2006-01-10,3,5,-121.4251955,38.56853798,2195,10076,4.59043280182232
"2196",2006-01-10,3,2,-121.4984069,38.5791674,2196,10078,4.58925318761384
"2197",2006-01-10,6,3,-121.4254625,38.54146972,2197,10081,4.58852981338188
"2198",2006-01-10,3,1,-121.4890397,38.5692795,2198,10082,4.58689717925387
"2199",2006-01-10,5,6,-121.4859396,38.48934244,2199,10088,4.58753979081401
"2200",2006-01-10,2,1,-121.4659998,38.62218315,2200,10089,4.58590909090909
"2201",2006-01-10,2,5,-121.4493987,38.63024715,2201,10094,4.58609722853249
"2202",2006-01-10,3,3,-121.4745497,38.58388345,2202,10097,4.58537693006358
"2203",2006-01-10,4,6,-121.5119629,38.52078633,2203,10103,4.58601906491148
"2204",2006-01-10,2,5,-121.4529308,38.6161168,2204,10108,4.58620689655172
"2205",2006-01-10,5,7,-121.4784328,38.48199912,2205,10115,4.58730158730159
"2206",2006-01-10,3,7,-121.3980671,38.5474759,2206,10122,4.58839528558477
"2207",2006-01-10,4,6,-121.5346969,38.50298477,2207,10128,4.58903488898958
"2208",2006-01-10,3,6,-121.5011657,38.58184562,2208,10134,4.58967391304348
"2209",2006-01-10,4,6,-121.5346969,38.50298477,2209,10140,4.59031235853327
"2210",2006-01-10,3,4,-121.3940644,38.54818818,2210,10144,4.59004524886878
"2211",2006-01-10,5,6,-121.4656033,38.48455742,2211,10150,4.5906829488919
"2212",2006-01-10,4,3,-121.5069385,38.53317666,2212,10153,4.58996383363472
"2213",2006-01-10,2,6,-121.3815598,38.63862878,2213,10159,4.59060099412562
"2214",2006-01-10,3,3,-121.3998489,38.55804061,2214,10162,4.58988256549232
"2215",2006-01-10,5,5,-121.4516915,38.48371518,2215,10167,4.59006772009029
"2216",2006-01-10,3,6,-121.48052,38.57160034,2216,10173,4.59070397111913
"2217",2006-01-10,5,7,-121.4611611,38.48574227,2217,10180,4.59179070816419
"2218",2006-01-10,6,8,-121.4647617,38.53952458,2218,10188,4.59332732191163
"2219",2006-01-10,4,1,-121.5122704,38.5601973,2219,10189,4.59170797656602
"2220",2006-01-10,2,2,-121.455905,38.63410573,2220,10191,4.59054054054054
"2221",2006-01-10,3,3,-121.4836302,38.57150442,2221,10194,4.58982440342188
"2222",2006-01-10,2,5,-121.4394524,38.62991663,2222,10199,4.59000900090009
"2223",2006-01-10,3,2,-121.5032275,38.58165678,2223,10201,4.58884390463338
"2224",2006-01-10,2,5,-121.4211729,38.59875634,2224,10206,4.58902877697842
"2225",2006-01-10,6,2,-121.4684935,38.55155803,2225,10208,4.58786516853933
"2226",2006-01-10,6,6,-121.4409152,38.51750189,2226,10214,4.5884995507637
"2227",2006-01-10,4,4,-121.4828349,38.49689915,2227,10218,4.58823529411765
"2228",2006-01-10,2,6,-121.3815598,38.63862878,2228,10224,4.58886894075404
"2229",2006-01-10,3,5,-121.4863575,38.58573502,2229,10229,4.58905338716913
"2230",2006-01-10,2,1,-121.4220758,38.60781149,2230,10230,4.58744394618834
"2231",2006-01-10,2,1,-121.4478727,38.63472676,2231,10231,4.58583594800538
"2232",2006-01-10,5,7,-121.4226974,38.46791937,2232,10238,4.58691756272401
"2233",2006-01-10,4,4,-121.5235515,38.49590431,2233,10242,4.58665472458576
"2234",2006-01-10,5,7,-121.46994,38.47826995,2234,10249,4.58773500447628
"2235",2006-01-10,2,1,-121.434294,38.62354293,2235,10250,4.58612975391499
"2236",2006-01-10,5,1,-121.4595052,38.49311839,2236,10251,4.5845259391771
"2237",2006-01-10,2,3,-121.4326726,38.64518402,2237,10254,4.58381761287439
"2238",2006-01-10,5,5,-121.4332115,38.46956131,2238,10259,4.5840035746202
"2239",2006-01-10,5,8,-121.4184079,38.46025863,2239,10267,4.58552925413131
"2240",2006-01-10,2,1,-121.4487064,38.61112661,2240,10268,4.58392857142857
"2241",2006-01-10,2,1,-121.4382088,38.61936618,2241,10269,4.58232931726908
"2242",2006-01-10,2,7,-121.4252477,38.60027317,2242,10276,4.58340767172168
"2243",2006-01-10,2,1,-121.4568936,38.64404243,2243,10277,4.58181007579135
"2244",2006-01-10,2,8,-121.4367266,38.63153999,2244,10285,4.58333333333333
"2245",2006-01-10,6,5,-121.4383522,38.51585289,2245,10290,4.58351893095768
"2246",2006-01-10,2,5,-121.4284911,38.6059953,2246,10295,4.58370436331256
"2247",2006-01-10,1,7,-121.5292529,38.66144962,2247,10302,4.58477970627503
"2248",2006-01-10,3,5,-121.4983269,38.56567077,2248,10307,4.58496441281139
"2249",2006-01-10,4,4,-121.5427895,38.4894192,2249,10311,4.58470431302801
"2250",2006-01-10,5,7,-121.4410698,38.47587955,2250,10318,4.58577777777778
"2251",2006-01-10,1,5,-121.5132343,38.64600077,2251,10323,4.58596179475789
"2252",2006-01-10,3,7,-121.4852542,38.56796664,2252,10330,4.58703374777975
"2253",2006-01-10,6,7,-121.4433516,38.53046628,2253,10337,4.58810474922326
"2254",2006-01-10,2,4,-121.4337087,38.62496247,2254,10341,4.58784383318545
"2255",2006-01-10,6,7,-121.4522664,38.52491808,2255,10348,4.58891352549889
"2256",2006-01-10,1,4,-121.4745819,38.64316291,2256,10352,4.5886524822695
"2257",2006-01-10,3,4,-121.3793225,38.55863257,2257,10356,4.58839167035888
"2258",2006-01-10,2,1,-121.4252477,38.60027317,2258,10357,4.58680248007086
"2259",2006-01-10,6,8,-121.4352432,38.53951607,2259,10365,4.58831341301461
"2260",2006-01-10,2,2,-121.4260658,38.63253662,2260,10367,4.58716814159292
"2261",2006-01-10,2,4,-121.4238252,38.5978936,2261,10371,4.58690844758956
"2262",2006-01-10,5,1,-121.4503108,38.47429277,2262,10372,4.58532272325376
"2263",2006-01-10,1,4,-121.5096441,38.65941872,2263,10376,4.58506407423774
"2264",2006-01-10,5,7,-121.4912852,38.47215453,2264,10383,4.58613074204947
"2265",2006-01-10,2,4,-121.4569463,38.61874708,2265,10387,4.58587196467991
"2266",2006-01-10,3,7,-121.482654,38.57829626,2266,10394,4.58693733451015
"2267",2006-01-10,5,7,-121.4718913,38.49547672,2267,10401,4.58800176444641
"2268",2006-01-10,4,7,-121.5302484,38.50990576,2268,10408,4.58906525573192
"2269",2006-01-10,1,7,-121.5295379,38.66123935,2269,10415,4.59012780960776
"2270",2006-01-10,6,7,-121.4335119,38.52285617,2270,10422,4.59118942731278
"2271",2006-01-10,6,5,-121.4448282,38.52983357,2271,10427,4.59136944077499
"2272",2006-01-10,2,5,-121.4230206,38.61041662,2272,10432,4.59154929577465
"2273",2006-01-10,4,7,-121.5224402,38.52991087,2273,10439,4.59260888693357
"2274",2006-01-10,1,7,-121.4756171,38.62809515,2274,10446,4.59366754617414
"2275",2006-01-10,6,6,-121.4647446,38.53760783,2275,10452,4.59428571428571
"2276",2006-01-10,6,5,-121.4407606,38.53634384,2276,10457,4.59446397188049
"2277",2006-01-10,1,5,-121.4966948,38.62648616,2277,10462,4.59464207290294
"2278",2006-01-10,6,7,-121.4455298,38.52501505,2278,10469,4.59569798068481
"2279",2006-01-10,3,5,-121.4698616,38.57732399,2279,10474,4.59587538394032
"2280",2006-01-10,3,7,-121.483399,38.57493581,2280,10481,4.5969298245614
"2281",2006-01-10,4,1,-121.4793485,38.51213446,2281,10482,4.59535291538799
"2282",2006-01-10,5,7,-121.4301179,38.45585205,2282,10489,4.59640666082384
"2283",2006-01-10,6,1,-121.4593645,38.54677899,2283,10490,4.59483136224266
"2284",2006-01-10,4,5,-121.4793485,38.51213446,2284,10495,4.59500875656743
"2285",2006-01-10,6,3,-121.4424934,38.52709836,2285,10498,4.59431072210066
"2286",2006-01-10,2,1,-121.4547111,38.62863295,2286,10499,4.59273840769904
"2287",2006-01-10,2,7,-121.4581238,38.64479784,2287,10506,4.59379099256668
"2288",2006-01-10,6,1,-121.4665635,38.54918489,2288,10507,4.59222027972028
"2289",2006-01-10,1,1,-121.4745819,38.64316291,2289,10508,4.59065093927479
"2290",2006-01-10,2,5,-121.4381896,38.64578755,2290,10513,4.59082969432314
"2291",2006-01-10,4,1,-121.507079,38.53408342,2291,10514,4.58926233085989
"2292",2006-01-10,6,3,-121.4703231,38.53166382,2292,10517,4.58856893542757
"2293",2006-01-10,3,5,-121.4049517,38.55211647,2293,10522,4.58874836458788
"2294",2006-01-10,3,2,-121.4855038,38.58428687,2294,10524,4.58761987794246
"2295",2006-01-10,1,7,-121.4927929,38.61009514,2295,10531,4.58867102396514
"2296",2006-01-10,4,3,-121.4712477,38.52718667,2296,10534,4.58797909407665
"2297",2006-01-10,3,4,-121.4785616,38.57633652,2297,10538,4.58772311710927
"2298",2006-01-10,1,5,-121.491563,38.61521091,2298,10543,4.58790252393386
"2299",2006-01-10,2,2,-121.4504318,38.6161187,2299,10545,4.58677685950413
"2300",2006-01-10,2,3,-121.4313716,38.63358427,2300,10548,4.58608695652174
"2301",2006-01-10,6,1,-121.4715398,38.55477924,2301,10549,4.5845284658844
"2302",2006-01-10,5,8,-121.42717,38.47421612,2302,10557,4.58601216333623
"2303",2006-01-10,6,1,-121.4140049,38.506135,2303,10558,4.58445505861919
"2304",2006-01-10,5,8,-121.4595052,38.49311839,2304,10566,4.5859375
"2305",2006-01-10,4,5,-121.5187097,38.51183814,2305,10571,4.58611713665944
"2306",2006-01-10,5,5,-121.4708286,38.493179,2306,10576,4.58629661751951
"2307",2006-01-10,1,5,-121.4920785,38.6140791,2307,10581,4.58647594278283
"2308",2006-01-10,4,7,-121.5185972,38.51297449,2308,10588,4.58752166377816
"2309",2006-01-10,6,5,-121.4274484,38.51052171,2309,10593,4.58770030316154
"2310",2006-01-10,3,7,-121.4791371,38.57368379,2310,10600,4.58874458874459
"2311",2006-01-10,5,1,-121.5013123,38.48131474,2311,10601,4.58719169190826
"2312",2006-01-10,6,5,-121.4162355,38.52567,2312,10606,4.58737024221453
"2313",2006-01-10,6,1,-121.4698767,38.55317349,2313,10607,4.58581928231734
"2314",2006-01-10,6,5,-121.4471706,38.52935875,2314,10612,4.58599827139153
"2315",2006-01-10,2,5,-121.4590874,38.62024815,2315,10617,4.58617710583153
"2316",2006-01-10,2,7,-121.4231806,38.61054373,2316,10624,4.58721934369603
"2317",2006-01-10,6,5,-121.4065734,38.53876024,2317,10629,4.58739749676306
"2318",2006-01-10,1,5,-121.5064872,38.62928795,2318,10634,4.58757549611734
"2319",2006-01-10,6,1,-121.4724356,38.55612335,2319,10635,4.58602846054334
"2320",2006-01-10,1,9,-121.4948028,38.61536788,2320,10644,4.58793103448276
"2321",2006-01-10,6,1,-121.4392101,38.55080199,2321,10645,4.58638517880224
"2322",2006-01-10,3,3,-121.4903293,38.58068906,2322,10648,4.58570198105082
"2323",2006-01-10,3,7,-121.4745598,38.57966847,2323,10655,4.58674128282393
"2324",2006-01-10,1,6,-121.4767711,38.62824591,2324,10661,4.58734939759036
"2325",2006-01-10,6,7,-121.4095907,38.51084657,2325,10668,4.58838709677419
"2326",2006-01-10,5,5,-121.4762198,38.48412546,2326,10673,4.58856405846948
"2327",2006-01-10,6,5,-121.4551842,38.55619719,2327,10678,4.58874086807048
"2328",2006-01-10,5,5,-121.4161718,38.46337225,2328,10683,4.5889175257732
"2329",2006-01-10,4,1,-121.4907389,38.53849952,2329,10684,4.587376556462
"2330",2006-01-10,2,2,-121.4562911,38.64270234,2330,10686,4.5862660944206
"2331",2006-01-10,5,1,-121.505075,38.48126775,2331,10687,4.58472758472758
"2332",2006-01-10,6,1,-121.4630967,38.55078622,2332,10688,4.58319039451115
"2333",2006-01-10,5,1,-121.4292715,38.43809806,2333,10689,4.58165452207458
"2334",2006-01-10,5,1,-121.4292715,38.43809806,2334,10690,4.58011996572408
"2335",2006-01-10,2,2,-121.4461937,38.61112011,2335,10692,4.57901498929336
"2336",2006-01-10,2,5,-121.4478727,38.63472676,2336,10697,4.57919520547945
"2337",2006-01-10,4,7,-121.4973062,38.49708379,2337,10704,4.58023106546855
"2338",2006-01-10,4,7,-121.5192421,38.53345635,2338,10711,4.58126603934987
"2339",2006-01-11,4,7,-121.5314103,38.47504537,2339,10718,4.58230012825994
"2340",2006-01-11,3,1,-121.4696312,38.57115555,2340,10719,4.58076923076923
"2341",2006-01-11,4,4,-121.4863745,38.52604112,2341,10723,4.58052114480991
"2342",2006-01-11,4,4,-121.5313861,38.47501232,2342,10727,4.5802732707088
"2343",2006-01-11,2,4,-121.4533125,38.60286119,2343,10731,4.58002560819462
"2344",2006-01-11,1,3,-121.4799069,38.608676,2344,10734,4.57935153583618
"2345",2006-01-11,1,6,-121.5055012,38.6715134,2345,10740,4.57995735607676
"2346",2006-01-11,3,7,-121.4043052,38.55123169,2346,10747,4.58098891730605
"2347",2006-01-11,2,3,-121.4438554,38.61655961,2347,10750,4.58031529612271
"2348",2006-01-11,5,3,-121.4724244,38.48149132,2348,10753,4.57964224872232
"2349",2006-01-11,5,5,-121.4530858,38.48230213,2349,10758,4.57982120051086
"2350",2006-01-11,2,3,-121.4291487,38.64493057,2350,10761,4.57914893617021
"2351",2006-01-11,3,1,-121.4775255,38.58215599,2351,10762,4.57762654189707
"2352",2006-01-11,4,5,-121.4827348,38.49575914,2352,10767,4.57780612244898
"2353",2006-01-11,3,2,-121.4104346,38.55721356,2353,10769,4.57671058223544
"2354",2006-01-11,2,6,-121.4438793,38.61394284,2354,10775,4.57731520815633
"2355",2006-01-11,4,7,-121.5036133,38.49605385,2355,10782,4.57834394904459
"2356",2006-01-11,2,3,-121.441537,38.62612905,2356,10785,4.5776740237691
"2357",2006-01-11,1,7,-121.4745819,38.64316291,2357,10792,4.57870173949936
"2358",2006-01-11,2,5,-121.4220758,38.60781149,2358,10797,4.57888040712468
"2359",2006-01-11,3,2,-121.4521612,38.57052225,2359,10799,4.57778719796524
"2360",2006-01-11,2,5,-121.4423479,38.64775726,2360,10804,4.57796610169492
"2361",2006-01-11,4,7,-121.5183333,38.51272351,2361,10811,4.57899195256247
"2362",2006-01-11,6,2,-121.4671318,38.55128541,2362,10813,4.57790008467401
"2363",2006-01-11,5,1,-121.4608299,38.48472747,2363,10814,4.57638595006348
"2364",2006-01-11,6,7,-121.4364025,38.53128662,2364,10821,4.57741116751269
"2365",2006-01-11,2,2,-121.4199574,38.60107058,2365,10823,4.57632135306554
"2366",2006-01-11,3,7,-121.4862332,38.56946478,2366,10830,4.57734573119189
"2367",2006-01-11,1,1,-121.471755,38.6112148,2367,10831,4.5758343895226
"2368",2006-01-11,3,5,-121.5074956,38.56845333,2368,10836,4.57601351351351
"2369",2006-01-11,3,6,-121.492564,38.57143409,2369,10842,4.5766146053187
"2370",2006-01-11,4,3,-121.5332347,38.49788243,2370,10845,4.57594936708861
"2371",2006-01-11,4,6,-121.4808562,38.50039411,2371,10851,4.57654997891185
"2372",2006-01-11,3,7,-121.3859386,38.55056728,2372,10858,4.57757166947723
"2373",2006-01-11,2,7,-121.4425742,38.63046166,2373,10865,4.57859249894648
"2374",2006-01-11,2,5,-121.4331423,38.63763772,2374,10870,4.5787700084246
"2375",2006-01-11,1,5,-121.5221311,38.62776914,2375,10875,4.57894736842105
"2376",2006-01-11,2,5,-121.4599427,38.65012521,2376,10880,4.57912457912458
"2377",2006-01-11,3,7,-121.3846687,38.56442488,2377,10887,4.58014303744215
"2378",2006-01-11,6,3,-121.4222955,38.50596801,2378,10890,4.57947855340622
"2379",2006-01-11,2,7,-121.4385384,38.62329722,2379,10897,4.58049600672551
"2380",2006-01-11,3,7,-121.4054638,38.55108662,2380,10904,4.58151260504202
"2381",2006-01-11,1,7,-121.5048486,38.65956858,2381,10911,4.58252834943301
"2382",2006-01-11,2,3,-121.438413,38.65831287,2382,10914,4.58186397984887
"2383",2006-01-11,4,7,-121.5181204,38.48782523,2383,10921,4.5828787242971
"2384",2006-01-11,2,5,-121.4284714,38.59971248,2384,10926,4.58305369127517
"2385",2006-01-11,1,1,-121.5396858,38.64302793,2385,10927,4.58155136268344
"2386",2006-01-11,1,1,-121.4988152,38.61266409,2386,10928,4.58005029337804
"2387",2006-01-11,1,6,-121.4890137,38.61344504,2387,10934,4.58064516129032
"2388",2006-01-11,2,7,-121.423624,38.61283605,2388,10941,4.58165829145729
"2389",2006-01-11,3,7,-121.4903653,38.57173197,2389,10948,4.5826705734617
"2390",2006-01-11,2,6,-121.451819,38.65875599,2390,10954,4.58326359832636
"2391",2006-01-11,5,3,-121.4859396,38.48934244,2391,10957,4.58260142199916
"2392",2006-01-11,2,5,-121.4438493,38.63484756,2392,10962,4.58277591973244
"2393",2006-01-11,5,5,-121.4654193,38.48160193,2393,10967,4.58295027162557
"2394",2006-01-11,2,3,-121.4377865,38.6569451,2394,10970,4.58228905597327
"2395",2006-01-11,3,2,-121.4984069,38.5791674,2395,10972,4.5812108559499
"2396",2006-01-11,6,7,-121.4321259,38.50726336,2396,10979,4.5822203672788
"2397",2006-01-11,3,2,-121.465972,38.57262977,2397,10981,4.58114309553609
"2398",2006-01-11,3,1,-121.4938681,38.58285466,2398,10982,4.57964970809008
"2399",2006-01-11,5,6,-121.4951552,38.48947366,2399,10988,4.58024176740308
"2400",2006-01-11,5,7,-121.468123,38.47317612,2400,10995,4.58125
"2401",2006-01-11,6,7,-121.471825,38.53514705,2401,11002,4.58225739275302
"2402",2006-01-11,5,7,-121.4990513,38.48292781,2402,11009,4.58326394671107
"2403",2006-01-11,3,6,-121.4300538,38.55451921,2403,11015,4.58385351643779
"2404",2006-01-11,2,1,-121.4458043,38.61483626,2404,11016,4.58236272878536
"2405",2006-01-11,3,4,-121.4832354,38.59124596,2405,11020,4.58212058212058
"2406",2006-01-11,2,3,-121.4268781,38.6111909,2406,11023,4.58146300914381
"2407",2006-01-11,3,1,-121.4916456,38.58104084,2407,11024,4.57997507270461
"2408",2006-01-11,3,1,-121.481959,38.5906691,2408,11025,4.57848837209302
"2409",2006-01-11,3,5,-121.4883415,38.587136,2409,11030,4.57866334578663
"2410",2006-01-11,2,6,-121.4347477,38.63475409,2410,11036,4.57925311203319
"2411",2006-01-11,4,4,-121.4737197,38.49580633,2411,11040,4.57901285773538
"2412",2006-01-11,3,1,-121.481959,38.5906691,2412,11041,4.57752902155887
"2413",2006-01-11,3,1,-121.5014414,38.58243993,2413,11042,4.57604641525073
"2414",2006-01-11,1,7,-121.4989028,38.62610032,2414,11049,4.57705053852527
"2415",2006-01-11,6,1,-121.4256229,38.54804158,2415,11050,4.57556935817805
"2416",2006-01-11,4,7,-121.4982191,38.52131791,2416,11057,4.57657284768212
"2417",2006-01-11,5,7,-121.4216597,38.46753799,2417,11064,4.57757550682664
"2418",2006-01-11,4,7,-121.4866729,38.56037767,2418,11071,4.57857733664185
"2419",2006-01-11,1,7,-121.4790946,38.6101634,2419,11078,4.57957833815626
"2420",2006-01-11,3,1,-121.4974099,38.58314743,2420,11079,4.57809917355372
"2421",2006-01-11,4,1,-121.4829201,38.50684258,2421,11080,4.57662123089632
"2422",2006-01-11,3,2,-121.4102522,38.57209021,2422,11082,4.57555739058629
"2423",2006-01-11,2,7,-121.4522227,38.63448929,2423,11089,4.57655798596781
"2424",2006-01-11,5,4,-121.4281268,38.47295223,2424,11093,4.5763201320132
"2425",2006-01-11,3,7,-121.4107516,38.54888945,2425,11100,4.57731958762887
"2426",2006-01-11,6,1,-121.4467668,38.54672494,2426,11101,4.57584501236603
"2427",2006-01-11,6,5,-121.4442915,38.52469057,2427,11106,4.57601977750309
"2428",2006-01-11,3,2,-121.4832354,38.59124596,2428,11108,4.57495881383855
"2429",2006-01-11,4,1,-121.4908853,38.5488551,2429,11109,4.57348703170029
"2430",2006-01-11,3,4,-121.4908532,38.56855432,2430,11113,4.57325102880658
"2431",2006-01-11,3,1,-121.4981108,38.58148094,2431,11114,4.57178116001645
"2432",2006-01-11,6,3,-121.4687016,38.54850275,2432,11117,4.57113486842105
"2433",2006-01-11,3,5,-121.4861182,38.57087568,2433,11122,4.57131113851213
"2434",2006-01-11,2,3,-121.4578571,38.63980996,2434,11125,4.57066557107642
"2435",2006-01-11,3,1,-121.48322,38.58612197,2435,11126,4.56919917864476
"2436",2006-01-11,6,1,-121.4386867,38.54665856,2436,11127,4.56773399014778
"2437",2006-01-11,5,5,-121.4363632,38.46365645,2437,11132,4.56791136643414
"2438",2006-01-11,3,5,-121.4701627,38.57164676,2438,11137,4.56808859721083
"2439",2006-01-11,1,5,-121.5234154,38.62783484,2439,11142,4.56826568265683
"2440",2006-01-11,4,5,-121.5395917,38.50963304,2440,11147,4.56844262295082
"2441",2006-01-11,4,6,-121.4960208,38.55199422,2441,11153,4.56902908643998
"2442",2006-01-11,4,7,-121.5002562,38.51692224,2442,11160,4.57002457002457
"2443",2006-01-11,6,1,-121.4667542,38.53863585,2443,11161,4.56856324191568
"2444",2006-01-11,6,1,-121.4674364,38.55451604,2444,11162,4.5671031096563
"2445",2006-01-11,4,8,-121.5178296,38.50812472,2445,11170,4.56850715746421
"2446",2006-01-11,3,4,-121.4956981,38.57686552,2446,11174,4.56827473426002
"2447",2006-01-11,2,4,-121.4487811,38.61460058,2447,11178,4.56804250102166
"2448",2006-01-11,4,1,-121.4937694,38.53514629,2448,11179,4.56658496732026
"2449",2006-01-11,3,1,-121.483793,38.58138778,2449,11180,4.56512862392813
"2450",2006-01-11,3,1,-121.5078603,38.57795857,2450,11181,4.56367346938775
"2451",2006-01-11,6,1,-121.4316473,38.51690753,2451,11182,4.56221950224398
"2452",2006-01-11,2,2,-121.4303406,38.59657483,2452,11184,4.56117455138662
"2453",2006-01-11,2,6,-121.4496554,38.61377272,2453,11190,4.56176110884631
"2454",2006-01-11,6,4,-121.4681974,38.53450711,2454,11194,4.56153219233904
"2455",2006-01-11,5,7,-121.5027455,38.47566977,2455,11201,4.56252545824847
"2456",2006-01-11,4,4,-121.4946473,38.53361515,2456,11205,4.56229641693811
"2457",2006-01-11,5,8,-121.4840434,38.49502083,2457,11213,4.56369556369556
"2458",2006-01-11,3,1,-121.4892102,38.57917936,2458,11214,4.56224572823434
"2459",2006-01-11,3,5,-121.4100955,38.55719536,2459,11219,4.56242374949166
"2460",2006-01-11,3,4,-121.4920847,38.58176769,2460,11223,4.56219512195122
"2461",2006-01-11,5,1,-121.4179521,38.46175837,2461,11224,4.5607476635514
"2462",2006-01-11,6,1,-121.4215197,38.5262375,2462,11225,4.55930138099106
"2463",2006-01-11,3,1,-121.4987072,38.5797426,2463,11226,4.557856272838
"2464",2006-01-11,6,1,-121.4311068,38.53955897,2464,11227,4.55641233766234
"2465",2006-01-11,4,4,-121.5084361,38.54718182,2465,11231,4.55618661257606
"2466",2006-01-11,3,3,-121.4826732,38.57372161,2466,11234,4.55555555555556
"2467",2006-01-11,6,1,-121.4111198,38.51613758,2467,11235,4.55411430887718
"2468",2006-01-11,6,1,-121.4162304,38.53015137,2468,11236,4.55267423014587
"2469",2006-01-11,3,6,-121.4879497,38.58615671,2469,11242,4.55326042932361
"2470",2006-01-11,6,1,-121.416569,38.52635817,2470,11243,4.55182186234818
"2471",2006-01-11,6,7,-121.4687076,38.53735699,2471,11250,4.55281262646702
"2472",2006-01-11,4,4,-121.510727,38.4971084,2472,11254,4.55258899676375
"2473",2006-01-11,2,1,-121.463553,38.6296408,2473,11255,4.55115244642135
"2474",2006-01-11,6,1,-121.465047,38.53877351,2474,11256,4.54971705739693
"2475",2006-01-11,6,6,-121.4438874,38.52496323,2475,11262,4.55030303030303
"2476",2006-01-11,6,1,-121.422581,38.52943634,2476,11263,4.54886914378029
"2477",2006-01-11,2,6,-121.421127,38.61390001,2477,11269,4.54945498587
"2478",2006-01-11,4,3,-121.5346969,38.50298477,2478,11272,4.54882970137207
"2479",2006-01-11,6,2,-121.4137141,38.52835927,2479,11274,4.54780153287616
"2480",2006-01-11,6,1,-121.422581,38.52943634,2480,11275,4.54637096774194
"2481",2006-01-11,6,1,-121.422581,38.52943634,2481,11276,4.54494155582426
"2482",2006-01-11,5,3,-121.4561777,38.47676441,2482,11279,4.54431909750201
"2483",2006-01-11,6,1,-121.4143431,38.5322315,2483,11280,4.54289166331051
"2484",2006-01-11,4,1,-121.5346969,38.50298477,2484,11281,4.5414653784219
"2485",2006-01-11,2,5,-121.4461579,38.62834524,2485,11286,4.54164989939638
"2486",2006-01-11,2,5,-121.4169566,38.63297991,2486,11291,4.54183427192277
"2487",2006-01-11,5,5,-121.4732803,38.493322,2487,11296,4.54201849618014
"2488",2006-01-11,5,7,-121.5029365,38.48285946,2488,11303,4.54300643086817
"2489",2006-01-11,3,7,-121.5011657,38.58184562,2489,11310,4.54399357171555
"2490",2006-01-11,6,1,-121.4111198,38.51613758,2490,11311,4.5425702811245
"2491",2006-01-11,6,1,-121.419027,38.53315305,2491,11312,4.54114813327981
"2492",2006-01-11,6,1,-121.4120437,38.52745012,2492,11313,4.53972712680578
"2493",2006-01-11,6,1,-121.422343,38.52860039,2493,11314,4.53830726032892
"2494",2006-01-11,6,1,-121.4211872,38.5288747,2494,11315,4.53688853247795
"2495",2006-01-11,6,1,-121.4186887,38.52962554,2495,11316,4.53547094188377
"2496",2006-01-11,4,4,-121.511165,38.56124982,2496,11320,4.53525641025641
"2497",2006-01-11,4,1,-121.5105536,38.49641294,2497,11321,4.53384060873048
"2498",2006-01-11,6,1,-121.4198513,38.52679481,2498,11322,4.5324259407526
"2499",2006-01-11,6,1,-121.4254625,38.54146972,2499,11323,4.53101240496198
"2500",2006-01-11,6,1,-121.4173663,38.53017083,2500,11324,4.5296
"2501",2006-01-11,2,1,-121.423349,38.59664183,2501,11325,4.5281887245102
"2502",2006-01-11,1,4,-121.5161468,38.65847399,2502,11329,4.52797761790568
"2503",2006-01-11,4,6,-121.4829107,38.55542922,2503,11335,4.52856572113464
"2504",2006-01-11,4,5,-121.4793661,38.49869042,2504,11340,4.52875399361022
"2505",2006-01-11,6,1,-121.4115532,38.52758492,2505,11341,4.52734530938124
"2506",2006-01-11,5,1,-121.4196575,38.47581524,2506,11342,4.52593774940144
"2507",2006-01-11,6,1,-121.4178524,38.53057968,2507,11343,4.52453131232549
"2508",2006-01-11,4,6,-121.4712477,38.52718667,2508,11349,4.52511961722488
"2509",2006-01-11,5,7,-121.4592772,38.49601155,2509,11356,4.526106018334
"2510",2006-01-11,6,1,-121.422338,38.52792486,2510,11357,4.52470119521912
"2511",2006-01-11,4,5,-121.5247086,38.49372331,2511,11362,4.52489048187973
"2512",2006-01-11,6,6,-121.4576223,38.54874242,2512,11368,4.52547770700637
"2513",2006-01-11,4,5,-121.5151766,38.48658549,2513,11373,4.52566653402308
"2514",2006-01-11,6,1,-121.4173676,38.53044268,2514,11374,4.52426412092283
"2515",2006-01-11,6,6,-121.4681928,38.52997079,2515,11380,4.52485089463221
"2516",2006-01-11,6,1,-121.4211933,38.53114288,2516,11381,4.52344992050874
"2517",2006-01-11,4,6,-121.47238,38.49742308,2517,11387,4.52403655145014
"2518",2006-01-11,4,8,-121.4790195,38.51554344,2518,11395,4.52541699761716
"2519",2006-01-11,6,1,-121.4170325,38.53166844,2519,11396,4.52401746724891
"2520",2006-01-11,4,5,-121.5222477,38.49180749,2520,11401,4.52420634920635
"2521",2006-01-11,2,3,-121.440024,38.62489157,2521,11404,4.52360174533915
"2522",2006-01-11,3,8,-121.3908868,38.54439581,2522,11412,4.52498017446471
"2523",2006-01-11,6,1,-121.4108607,38.53144221,2523,11413,4.52358303606817
"2524",2006-01-11,2,2,-121.4470317,38.61000927,2524,11415,4.52258320126783
"2525",2006-01-11,6,1,-121.4108607,38.53144221,2525,11416,4.52118811881188
"2526",2006-01-11,6,1,-121.4107513,38.53114234,2526,11417,4.51979414093428
"2527",2006-01-11,6,1,-121.4120459,38.52676364,2527,11418,4.5184012663237
"2528",2006-01-11,2,5,-121.4259738,38.60918188,2528,11423,4.5185917721519
"2529",2006-01-11,6,1,-121.4538401,38.54675579,2529,11424,4.51720047449585
"2530",2006-01-11,4,4,-121.5222888,38.4955943,2530,11428,4.51699604743083
"2531",2006-01-11,6,1,-121.4120459,38.52676364,2531,11429,4.51560647965231
"2532",2006-01-11,6,1,-121.4206712,38.53043731,2532,11430,4.51421800947867
"2533",2006-01-11,6,1,-121.4215197,38.5262375,2533,11431,4.51283063560995
"2534",2006-01-11,3,2,-121.493943,38.57920289,2534,11433,4.51183898973954
"2535",2006-01-11,3,6,-121.4868341,38.58464151,2535,11439,4.51242603550296
"2536",2006-01-11,4,7,-121.5250368,38.491127,2536,11446,4.51340694006309
"2537",2006-01-11,4,7,-121.5227003,38.51505369,2537,11453,4.51438707134411
"2538",2006-01-11,2,5,-121.4210338,38.6184743,2538,11458,4.51457840819543
"2539",2006-01-11,6,1,-121.4167866,38.53223561,2539,11459,4.51319417093344
"2540",2006-01-11,6,1,-121.4108607,38.53144221,2540,11460,4.51181102362205
"2541",2006-01-11,1,5,-121.5053633,38.61872505,2541,11465,4.51200314836678
"2542",2006-01-11,4,5,-121.5269234,38.51382164,2542,11470,4.51219512195122
"2543",2006-01-11,4,7,-121.5307469,38.49681243,2543,11477,4.51317341722375
"2544",2006-01-11,4,7,-121.5327897,38.47616031,2544,11484,4.51415094339623
"2545",2006-01-11,6,1,-121.4112162,38.52648208,2545,11485,4.51277013752456
"2546",2006-01-11,4,4,-121.4752017,38.54139021,2546,11489,4.51256873527101
"2547",2006-01-11,6,1,-121.4114177,38.52917414,2547,11490,4.51118963486455
"2548",2006-01-11,2,1,-121.4273239,38.64413073,2548,11491,4.50981161695447
"2549",2006-01-11,2,1,-121.426844,38.6437302,2549,11492,4.50843468026677
"2550",2006-01-11,4,5,-121.5135563,38.5182915,2550,11497,4.50862745098039
"2551",2006-01-11,2,2,-121.4465208,38.61000957,2551,11499,4.50764406115249
"2552",2006-01-11,6,5,-121.4435468,38.51170141,2552,11504,4.50783699059561
"2553",2006-01-11,2,1,-121.4569009,38.6476726,2553,11505,4.50646298472385
"2554",2006-01-11,2,6,-121.3815598,38.63862878,2554,11511,4.50704776820673
"2555",2006-01-11,5,5,-121.4538072,38.48435676,2555,11516,4.50724070450098
"2556",2006-01-11,4,5,-121.5108052,38.49742726,2556,11521,4.50743348982786
"2557",2006-01-11,4,6,-121.479014,38.53881527,2557,11527,4.50801720766523
"2558",2006-01-11,4,7,-121.5146732,38.51646465,2558,11534,4.50899139953088
"2559",2006-01-11,6,7,-121.4365804,38.51626989,2559,11541,4.50996483001172
"2560",2006-01-11,5,4,-121.4253051,38.44594829,2560,11545,4.509765625
"2561",2006-01-11,4,5,-121.5189173,38.48621943,2561,11550,4.50995704802811
"2562",2006-01-11,6,1,-121.4709972,38.54919426,2562,11551,4.50858704137393
"2563",2006-01-11,5,6,-121.4908472,38.48460818,2563,11557,4.50916894264534
"2564",2006-01-11,1,5,-121.4755356,38.62203999,2564,11562,4.50936037441498
"2565",2006-01-11,3,5,-121.4685593,38.56713881,2565,11567,4.50955165692008
"2566",2006-01-11,1,4,-121.5016816,38.6697424,2566,11571,4.50935307872175
"2567",2006-01-11,5,4,-121.4869243,38.49136508,2567,11575,4.50915465523958
"2568",2006-01-11,2,4,-121.4471131,38.61576515,2568,11579,4.50895638629283
"2569",2006-01-11,3,5,-121.4987072,38.5797426,2569,11584,4.5091475282211
"2570",2006-01-11,2,6,-121.4199227,38.64361887,2570,11590,4.50972762645914
"2571",2006-01-11,5,1,-121.4196575,38.47581524,2571,11591,4.50836250486192
"2572",2006-01-11,2,7,-121.4351575,38.64444377,2572,11598,4.50933125972006
"2573",2006-01-11,5,1,-121.4189709,38.47433721,2573,11599,4.5079673532841
"2574",2006-01-11,4,8,-121.5403218,38.50912795,2574,11607,4.50932400932401
"2575",2006-01-11,5,1,-121.4196575,38.47581524,2575,11608,4.50796116504854
"2576",2006-01-11,3,7,-121.4895092,38.56819418,2576,11615,4.50892857142857
"2577",2006-01-11,2,1,-121.4322662,38.62192663,2577,11616,4.50756693830035
"2578",2006-01-11,2,4,-121.4248097,38.6324535,2578,11620,4.50737005430566
"2579",2006-01-11,3,1,-121.4966071,38.57991197,2579,11621,4.50601008142691
"2580",2006-01-11,1,7,-121.5327445,38.64009771,2580,11628,4.50697674418605
"2581",2006-01-11,4,5,-121.5183094,38.51522221,2581,11633,4.50716776443239
"2582",2006-01-11,3,4,-121.489911,38.57900945,2582,11637,4.50697134004648
"2583",2006-01-11,4,8,-121.4808935,38.50921424,2583,11645,4.50832365466512
"2584",2006-01-11,3,4,-121.4689637,38.57341789,2584,11649,4.50812693498452
"2585",2006-01-11,1,5,-121.4948783,38.61211702,2585,11654,4.50831721470019
"2586",2006-01-11,6,5,-121.4416695,38.51177748,2586,11659,4.50850734725445
"2587",2006-01-11,5,5,-121.4885251,38.47713447,2587,11664,4.50869733281794
"2588",2006-01-11,1,5,-121.5257956,38.66417322,2588,11669,4.50888717156105
"2589",2006-01-11,5,5,-121.4384971,38.46365037,2589,11674,4.50907686365392
"2590",2006-01-11,2,7,-121.450194,38.64287128,2590,11681,4.51003861003861
"2591",2006-01-11,6,5,-121.4686663,38.5513666,2591,11686,4.51022771130838
"2592",2006-01-11,6,8,-121.4696677,38.54883395,2592,11694,4.51157407407407
"2593",2006-01-11,2,7,-121.4520581,38.59714644,2593,11701,4.51253374469726
"2594",2006-01-11,2,1,-121.4192999,38.61992921,2594,11702,4.51117964533539
"2595",2006-01-11,1,6,-121.4803834,38.60907905,2595,11708,4.51175337186898
"2596",2006-01-11,2,1,-121.4472415,38.61138598,2596,11709,4.51040061633282
"2597",2006-01-11,2,9,-121.4068418,38.63982914,2597,11718,4.51212938005391
"2598",2006-01-11,4,5,-121.4791876,38.50304742,2598,11723,4.51231716705158
"2599",2006-01-11,5,7,-121.4482596,38.46715727,2599,11730,4.51327433628319
"2600",2006-01-11,4,5,-121.4870624,38.56018718,2600,11735,4.51346153846154
"2601",2006-01-11,6,3,-121.4096668,38.51432608,2601,11738,4.51287966166859
"2602",2006-01-11,2,1,-121.4516505,38.61648144,2602,11739,4.51152959262106
"2603",2006-01-11,1,5,-121.5016816,38.6697424,2603,11744,4.5117172493277
"2604",2006-01-11,6,5,-121.388611,38.52393465,2604,11749,4.51190476190476
"2605",2006-01-11,6,5,-121.4177744,38.5217126,2605,11754,4.51209213051823
"2606",2006-01-11,6,4,-121.4331388,38.50557133,2606,11758,4.51189562547966
"2607",2006-01-11,2,3,-121.4646139,38.60350711,2607,11761,4.51131568853088
"2608",2006-01-11,2,7,-121.4252477,38.60027317,2608,11768,4.51226993865031
"2609",2006-01-11,4,7,-121.551578,38.49192221,2609,11775,4.51322345726332
"2610",2006-01-11,6,1,-121.4473982,38.53517026,2610,11776,4.51187739463602
"2611",2006-01-11,2,5,-121.4503031,38.61783155,2611,11781,4.51206434316354
"2612",2006-01-11,2,3,-121.4681757,38.60218075,2612,11784,4.5114854517611
"2613",2006-01-11,5,7,-121.5010455,38.48550389,2613,11791,4.51243781094527
"2614",2006-01-11,2,6,-121.459947,38.61812954,2614,11797,4.51300688599847
"2615",2006-01-11,6,1,-121.4575843,38.54454919,2615,11798,4.51166347992352
"2616",2006-01-11,6,5,-121.4325052,38.5470458,2616,11803,4.5118501529052
"2617",2006-01-11,6,7,-121.4443436,38.52652786,2617,11810,4.51280091708063
"2618",2006-01-11,3,5,-121.427895,38.55292689,2618,11815,4.51298701298701
"2619",2006-01-11,2,3,-121.4068481,38.63822005,2619,11818,4.51240931653303
"2620",2006-01-11,5,5,-121.4362016,38.48147413,2620,11823,4.51259541984733
"2621",2006-01-11,1,5,-121.528,38.63910642,2621,11828,4.51278138115223
"2622",2006-01-11,5,5,-121.4177615,38.43799945,2622,11833,4.51296720061022
"2623",2006-01-11,1,3,-121.5230491,38.62973626,2623,11836,4.51239039268014
"2624",2006-01-11,3,3,-121.431646,38.5741441,2624,11839,4.51181402439024
"2625",2006-01-11,2,5,-121.4068481,38.63822005,2625,11844,4.512
"2626",2006-01-11,6,1,-121.4622826,38.55952278,2626,11845,4.51066260472201
"2627",2006-01-11,5,1,-121.4196575,38.47581524,2627,11846,4.50932622763609
"2628",2006-01-11,6,5,-121.4305094,38.50795563,2628,11851,4.50951293759513
"2629",2006-01-11,2,6,-121.3815598,38.63862878,2629,11857,4.51007987828071
"2630",2006-01-11,2,6,-121.3815598,38.63862878,2630,11863,4.5106463878327
"2631",2006-01-11,2,3,-121.456171,38.60108154,2631,11866,4.5100722158875
"2632",2006-01-11,3,5,-121.40432,38.5494469,2632,11871,4.51025835866261
"2633",2006-01-11,5,7,-121.4233592,38.4681451,2633,11878,4.51120394986707
"2634",2006-01-11,4,4,-121.4852801,38.53626488,2634,11882,4.51100987091875
"2635",2006-01-11,1,7,-121.5231576,38.66689185,2635,11889,4.51195445920304
"2636",2006-01-11,6,4,-121.4386118,38.53217607,2636,11893,4.51176024279211
"2637",2006-01-11,5,2,-121.4271773,38.4706931,2637,11895,4.51080773606371
"2638",2006-01-11,4,4,-121.4968975,38.52733127,2638,11899,4.51061410159212
"2639",2006-01-11,2,5,-121.4540197,38.61514712,2639,11904,4.5107995452823
"2640",2006-01-11,2,3,-121.4461725,38.61294057,2640,11907,4.51022727272727
"2641",2006-01-11,5,6,-121.4421622,38.44781576,2641,11913,4.51079136690648
"2642",2006-01-11,1,7,-121.4808282,38.61865064,2642,11920,4.51173353520061
"2643",2006-01-11,3,7,-121.4768514,38.57342085,2643,11927,4.51267499054105
"2644",2006-01-11,2,3,-121.4660204,38.63485301,2644,11930,4.51210287443268
"2645",2006-01-11,4,8,-121.5048399,38.52324663,2645,11938,4.51342155009452
"2646",2006-01-11,5,1,-121.4196575,38.47581524,2646,11939,4.51209372637944
"2647",2006-01-11,4,7,-121.4977727,38.5286339,2647,11946,4.5130336229694
"2648",2006-01-11,3,4,-121.4910186,38.56987859,2648,11950,4.51283987915408
"2649",2006-01-11,5,5,-121.4644874,38.48149327,2649,11955,4.51302378255946
"2650",2006-01-12,4,5,-121.5090513,38.50096483,2650,11960,4.51320754716981
"2651",2006-01-12,4,7,-121.497206,38.52472122,2651,11967,4.51414560543191
"2652",2006-01-12,1,7,-121.5334978,38.61058202,2652,11974,4.51508295625943
"2653",2006-01-12,1,7,-121.5013594,38.62069319,2653,11981,4.51601960045232
"2654",2006-01-12,6,4,-121.4120984,38.52335069,2654,11985,4.51582516955539
"2655",2006-01-12,3,7,-121.48899,38.56644821,2655,11992,4.51676082862524
"2656",2006-01-12,6,5,-121.4445317,38.51133269,2656,11997,4.51694277108434
"2657",2006-01-12,2,4,-121.4387627,38.63437819,2657,12001,4.51674821226948
"2658",2006-01-12,6,6,-121.4572299,38.55161009,2658,12007,4.51730624529722
"2659",2006-01-12,6,5,-121.4239425,38.51926114,2659,12012,4.51748777735991
"2660",2006-01-12,6,6,-121.4311541,38.52003,2660,12018,4.51804511278196
"2661",2006-01-12,1,7,-121.5323364,38.64998963,2661,12025,4.51897782788425
"2662",2006-01-12,5,7,-121.4592772,38.49601155,2662,12032,4.51990984222389
"2663",2006-01-12,3,7,-121.4143199,38.56104193,2663,12039,4.52084115659031
"2664",2006-01-12,1,2,-121.4755286,38.6296517,2664,12041,4.51989489489489
"2665",2006-01-12,2,1,-121.443841,38.62559095,2665,12042,4.51857410881801
"2666",2006-01-12,1,5,-121.5271508,38.63411086,2666,12047,4.51875468867217
"2667",2006-01-12,1,5,-121.4990818,38.61308537,2667,12052,4.51893513310836
"2668",2006-01-12,3,1,-121.4278339,38.55443686,2668,12053,4.51761619190405
"2669",2006-01-12,5,1,-121.458006,38.49362212,2669,12054,4.51629823904084
"2670",2006-01-12,6,5,-121.4703569,38.5563198,2670,12059,4.51647940074906
"2671",2006-01-12,6,2,-121.4346997,38.50661145,2671,12061,4.51553725196556
"2672",2006-01-12,1,4,-121.4954943,38.61013165,2672,12065,4.51534431137725
"2673",2006-01-12,6,8,-121.4714437,38.55500397,2673,12073,4.51664796109241
"2674",2006-01-12,3,4,-121.4957638,38.57846394,2674,12077,4.51645474943904
"2675",2006-01-12,4,7,-121.5128703,38.51023478,2675,12084,4.51738317757009
"2676",2006-01-12,3,5,-121.4093934,38.5554124,2676,12089,4.51756352765321
"2677",2006-01-12,3,7,-121.425397,38.55394974,2677,12096,4.51849084796414
"2678",2006-01-12,3,5,-121.4960582,38.56749245,2678,12101,4.51867064973861
"2679",2006-01-12,3,7,-121.4277944,38.58029802,2679,12108,4.51959686450168
"2680",2006-01-12,2,6,-121.456947,38.6126813,2680,12114,4.52014925373134
"2681",2006-01-12,1,7,-121.5271363,38.60938371,2681,12121,4.52107422603506
"2682",2006-01-12,1,5,-121.4808279,38.62974422,2682,12126,4.52125279642058
"2683",2006-01-12,3,7,-121.4344047,38.57826555,2683,12133,4.52217666790906
"2684",2006-01-12,3,7,-121.4914727,38.58419516,2684,12140,4.5230998509687
"2685",2006-01-12,5,4,-121.4594267,38.47394034,2685,12144,4.52290502793296
"2686",2006-01-12,2,8,-121.4203309,38.64509274,2686,12152,4.52419955323902
"2687",2006-01-12,6,5,-121.4109325,38.53290342,2687,12157,4.5243766282099
"2688",2006-01-12,4,7,-121.5126595,38.49451616,2688,12164,4.52529761904762
"2689",2006-01-12,5,5,-121.4291863,38.45006998,2689,12169,4.52547415396058
"2690",2006-01-12,3,7,-121.3896927,38.55155646,2690,12176,4.52639405204461
"2691",2006-01-12,2,5,-121.4397435,38.62984389,2691,12181,4.52657004830918
"2692",2006-01-12,2,8,-121.4301509,38.6264498,2692,12189,4.5278603268945
"2693",2006-01-12,4,1,-121.4727965,38.52904451,2693,12190,4.52655031563312
"2694",2006-01-12,5,7,-121.4423059,38.46833142,2694,12197,4.52746844840386
"2695",2006-01-12,2,2,-121.4042501,38.63908268,2695,12199,4.5265306122449
"2696",2006-01-12,4,1,-121.4753422,38.5393973,2696,12200,4.52522255192878
"2697",2006-01-12,4,1,-121.4734384,38.53159017,2697,12201,4.52391546162403
"2698",2006-01-12,3,6,-121.4826732,38.57372161,2698,12207,4.52446256486286
"2699",2006-01-12,4,3,-121.4894103,38.53069245,2699,12210,4.52389773990367
"2700",2006-01-12,4,1,-121.47576,38.54106323,2700,12211,4.52259259259259
"2701",2006-01-12,4,1,-121.4753422,38.5393973,2701,12212,4.52128841169937
"2702",2006-01-12,6,4,-121.4629125,38.53391703,2702,12216,4.52109548482605
"2703",2006-01-12,2,5,-121.426719,38.62009248,2703,12221,4.5212726600074
"2704",2006-01-12,3,7,-121.3982046,38.56890331,2704,12228,4.52218934911243
"2705",2006-01-12,2,4,-121.4470349,38.60960014,2705,12232,4.52199630314233
"2706",2006-01-12,2,3,-121.4503321,38.64449478,2706,12235,4.52143385070214
"2707",2006-01-12,3,4,-121.4093934,38.5554124,2707,12239,4.52124122644994
"2708",2006-01-12,6,4,-121.4238404,38.52454934,2708,12243,4.52104874446086
"2709",2006-01-12,4,1,-121.4758058,38.54482538,2709,12244,4.51974898486526
"2710",2006-01-12,1,8,-121.5015961,38.67245501,2710,12252,4.5210332103321
"2711",2006-01-12,5,5,-121.4316068,38.45877009,2711,12257,4.52120988565105
"2712",2006-01-12,3,5,-121.5006108,38.57916319,2712,12262,4.52138643067847
"2713",2006-01-12,4,1,-121.4744133,38.55681883,2713,12263,4.52008846295614
"2714",2006-01-12,3,4,-121.489532,38.5767314,2714,12267,4.51989683124539
"2715",2006-01-12,3,4,-121.4882018,38.57637679,2715,12271,4.51970534069982
"2716",2006-01-12,3,4,-121.4909914,38.57712226,2716,12275,4.51951399116348
"2717",2006-01-12,2,1,-121.4502358,38.61158147,2717,12276,4.51821862348178
"2718",2006-01-12,6,2,-121.4699527,38.53117884,2718,12278,4.51729212656365
"2719",2006-01-12,1,5,-121.528827,38.66283184,2719,12283,4.51746965796249
"2720",2006-01-12,6,3,-121.4621574,38.5533905,2720,12286,4.51691176470588
"2721",2006-01-12,4,1,-121.4727965,38.52904451,2721,12287,4.51561925762587
"2722",2006-01-12,1,5,-121.4717489,38.61393325,2722,12292,4.51579720793534
"2723",2006-01-12,3,4,-121.4645499,38.57428724,2723,12296,4.51560778553066
"2724",2006-01-12,4,1,-121.4734384,38.53159017,2724,12297,4.51431718061674
"2725",2006-01-12,4,7,-121.5152564,38.47586021,2725,12304,4.51522935779817
"2726",2006-01-12,6,5,-121.4689027,38.55060706,2726,12309,4.51540719002201
"2727",2006-01-12,2,5,-121.4260323,38.62495215,2727,12314,4.51558489182252
"2728",2006-01-12,3,3,-121.5015372,38.57874706,2728,12317,4.5150293255132
"2729",2006-01-12,4,1,-121.47576,38.54106323,2729,12318,4.51374129717845
"2730",2006-01-12,1,7,-121.5102676,38.65735092,2730,12325,4.51465201465201
"2731",2006-01-12,3,5,-121.3933346,38.5505294,2731,12330,4.51482973269865
"2732",2006-01-12,4,1,-121.4741684,38.53452891,2732,12331,4.51354319180088
"2733",2006-01-12,6,1,-121.4189929,38.51286852,2733,12332,4.51225759238932
"2734",2006-01-12,4,1,-121.4754644,38.5399031,2734,12333,4.51097293343087
"2735",2006-01-12,6,8,-121.4564145,38.54434873,2735,12341,4.51224862888483
"2736",2006-01-12,5,3,-121.4630104,38.48093723,2736,12344,4.51169590643275
"2737",2006-01-12,5,4,-121.4787435,38.48250578,2737,12348,4.51150895140665
"2738",2006-01-12,2,7,-121.3745288,38.64191365,2738,12355,4.51241782322863
"2739",2006-01-12,1,1,-121.5158001,38.6662188,2739,12356,4.51113545089449
"2740",2006-01-12,2,6,-121.3815598,38.63862878,2740,12362,4.51167883211679
"2741",2006-01-12,4,1,-121.4717471,38.52488785,2741,12363,4.51039766508574
"2742",2006-01-12,4,1,-121.4739615,38.53366299,2742,12364,4.509117432531
"2743",2006-01-12,4,7,-121.5335826,38.48794356,2743,12371,4.51002551950419
"2744",2006-01-12,5,6,-121.4563619,38.47000751,2744,12377,4.51056851311953
"2745",2006-01-12,2,4,-121.4146721,38.64558877,2745,12381,4.5103825136612
"2746",2006-01-12,4,1,-121.4725316,38.52799984,2746,12382,4.50910415149308
"2747",2006-01-12,5,5,-121.465181,38.50316747,2747,12387,4.50928285402257
"2748",2006-01-12,2,7,-121.4219821,38.6038294,2748,12394,4.51018922852984
"2749",2006-01-12,3,1,-121.4778909,38.59102702,2749,12395,4.508912331757
"2750",2006-01-12,3,1,-121.4821111,38.56586845,2750,12396,4.50763636363636
"2751",2006-01-12,4,1,-121.4727965,38.52904451,2751,12397,4.50636132315522
"2752",2006-01-12,4,1,-121.4730308,38.52997919,2752,12398,4.50508720930233
"2753",2006-01-12,5,7,-121.4348784,38.47431447,2753,12405,4.50599346167817
"2754",2006-01-12,4,7,-121.5231426,38.49540836,2754,12412,4.50689905591866
"2755",2006-01-12,4,1,-121.4727187,38.52633116,2755,12413,4.50562613430127
"2756",2006-01-12,6,8,-121.4402677,38.51181739,2756,12421,4.50689404934688
"2757",2006-01-12,5,6,-121.4414788,38.44947376,2757,12427,4.50743561842583
"2758",2006-01-12,3,3,-121.4862884,38.57151899,2758,12430,4.50688905003626
"2759",2006-01-12,4,6,-121.4960208,38.55199422,2759,12436,4.5074302283436
"2760",2006-01-12,1,7,-121.5323364,38.64998963,2760,12443,4.50833333333333
"2761",2006-01-12,3,4,-121.4388125,38.56356872,2761,12447,4.50814922129663
"2762",2006-01-12,3,6,-121.4521612,38.57052225,2762,12453,4.50868935553946
"2763",2006-01-12,4,1,-121.4733703,38.52803387,2763,12454,4.50741947158885
"2764",2006-01-12,1,1,-121.5335334,38.65275137,2764,12455,4.5061505065123
"2765",2006-01-12,4,8,-121.4946908,38.55067586,2765,12463,4.50741410488246
"2766",2006-01-12,6,7,-121.4436379,38.53140402,2766,12470,4.50831525668836
"2767",2006-01-12,4,1,-121.473272,38.53092764,2767,12471,4.50704734369353
"2768",2006-01-12,3,3,-121.4403257,38.56148913,2768,12474,4.50650289017341
"2769",2006-01-12,6,7,-121.4569611,38.55337722,2769,12481,4.50740339472734
"2770",2006-01-12,4,1,-121.4739615,38.53366299,2770,12482,4.50613718411552
"2771",2006-01-12,4,1,-121.4733703,38.52803387,2771,12483,4.50487188740527
"2772",2006-01-12,2,5,-121.4189763,38.62055915,2772,12488,4.50505050505051
"2773",2006-01-12,6,1,-121.4618254,38.544558,2773,12489,4.50378651280202
"2774",2006-01-12,3,4,-121.4774355,38.56388684,2774,12493,4.50360490266763
"2775",2006-01-12,6,2,-121.4538401,38.54675579,2775,12495,4.5027027027027
"2776",2006-01-12,4,1,-121.4753422,38.5393973,2776,12496,4.5014409221902
"2777",2006-01-12,4,1,-121.4717471,38.52488785,2777,12497,4.50018005041412
"2778",2006-01-12,4,1,-121.4727965,38.52904451,2778,12498,4.49892008639309
"2779",2006-01-12,1,3,-121.4800678,38.63076504,2779,12501,4.49838071248651
"2780",2006-01-12,6,7,-121.4233955,38.5069236,2780,12508,4.49928057553957
"2781",2006-01-12,4,2,-121.4857011,38.55982692,2781,12510,4.49838187702265
"2782",2006-01-12,1,8,-121.4941577,38.61256421,2782,12518,4.49964054636952
"2783",2006-01-12,4,4,-121.5212433,38.49466185,2783,12522,4.49946101329501
"2784",2006-01-12,6,3,-121.4734483,38.55868443,2784,12525,4.4989224137931
"2785",2006-01-12,6,1,-121.4650462,38.53795521,2785,12526,4.49766606822262
"2786",2006-01-12,6,1,-121.4254625,38.54146972,2786,12527,4.49641062455133
"2787",2006-01-12,3,4,-121.4695145,38.56285677,2787,12531,4.4962325080732
"2788",2006-01-12,6,3,-121.4509881,38.54751665,2788,12534,4.49569583931133
"2789",2006-01-12,5,8,-121.4673944,38.49407763,2789,12542,4.49695231265687
"2790",2006-01-12,4,8,-121.5346969,38.50298477,2790,12550,4.49820788530466
"2791",2006-01-12,2,5,-121.4699668,38.65262086,2791,12555,4.49838767466858
"2792",2006-01-12,2,5,-121.4449624,38.63486114,2792,12560,4.49856733524355
"2793",2006-01-12,6,6,-121.4558291,38.54454369,2793,12566,4.49910490511994
"2794",2006-01-12,4,4,-121.4763166,38.54049185,2794,12570,4.49892627057981
"2795",2006-01-12,6,3,-121.4355549,38.5394462,2795,12573,4.49838998211091
"2796",2006-01-12,3,7,-121.5008344,38.58370044,2796,12580,4.49928469241774
"2797",2006-01-12,3,2,-121.4883111,38.58602101,2797,12582,4.49839113335717
"2798",2006-01-12,4,1,-121.473272,38.53092764,2798,12583,4.49714081486776
"2799",2006-01-12,4,1,-121.4726437,38.52559491,2799,12584,4.49589138978206
"2800",2006-01-12,1,5,-121.4886519,38.62290045,2800,12589,4.49607142857143
"2801",2006-01-12,6,7,-121.4181768,38.50450574,2801,12596,4.49696536951089
"2802",2006-01-12,3,7,-121.4425982,38.58039221,2802,12603,4.49785867237687
"2803",2006-01-12,4,1,-121.4705174,38.52903959,2803,12604,4.49661077417053
"2804",2006-01-12,4,7,-121.5039523,38.56094454,2804,12611,4.49750356633381
"2805",2006-01-12,3,3,-121.4809741,38.59283398,2805,12614,4.4969696969697
"2806",2006-01-12,2,3,-121.4315006,38.60468382,2806,12617,4.49643620812545
"2807",2006-01-12,4,1,-121.4705174,38.52903959,2807,12618,4.49519059494122
"2808",2006-01-12,4,7,-121.5125729,38.55788924,2808,12625,4.49608262108262
"2809",2006-01-12,3,6,-121.4630968,38.58052479,2809,12631,4.49661801352795
"2810",2006-01-12,6,8,-121.4585685,38.53970995,2810,12639,4.49786476868327
"2811",2006-01-12,4,1,-121.473503,38.53184858,2811,12640,4.49662041977944
"2812",2006-01-12,2,5,-121.4305962,38.63292418,2812,12645,4.49679943100996
"2813",2006-01-12,4,1,-121.4721784,38.52659231,2813,12646,4.49555634553857
"2814",2006-01-12,3,3,-121.4818667,38.58121716,2814,12649,4.49502487562189
"2815",2006-01-12,1,5,-121.5090098,38.61931721,2815,12654,4.49520426287744
"2816",2006-01-12,1,8,-121.5100794,38.64245072,2816,12662,4.49644886363636
"2817",2006-01-12,5,4,-121.4673944,38.49407763,2817,12666,4.49627263045793
"2818",2006-01-12,4,3,-121.5437781,38.50749407,2818,12669,4.49574166075231
"2819",2006-01-12,5,4,-121.4859396,38.48934244,2819,12673,4.49556580347641
"2820",2006-01-12,5,8,-121.42384,38.46830127,2820,12681,4.4968085106383
"2821",2006-01-12,4,1,-121.4758233,38.54815629,2821,12682,4.49556894718185
"2822",2006-01-12,5,1,-121.4854238,38.47849643,2822,12683,4.49433026222537
"2823",2006-01-12,1,2,-121.503035,38.61982993,2823,12685,4.49344668792065
"2824",2006-01-12,6,7,-121.4729887,38.55367374,2824,12692,4.4943342776204
"2825",2006-01-12,4,7,-121.4990149,38.52199137,2825,12699,4.49522123893805
"2826",2006-01-12,5,7,-121.4429865,38.44688612,2826,12706,4.49610757254069
"2827",2006-01-12,5,5,-121.4760448,38.49511942,2827,12711,4.49628581535196
"2828",2006-01-12,4,1,-121.473503,38.53184858,2828,12712,4.4950495049505
"2829",2006-01-12,4,1,-121.473503,38.53184858,2829,12713,4.49381406857547
"2830",2006-01-12,4,1,-121.4727965,38.52904451,2830,12714,4.49257950530035
"2831",2006-01-12,5,1,-121.42717,38.47421612,2831,12715,4.49134581419993
"2832",2006-01-12,4,5,-121.4776224,38.53405028,2832,12720,4.49152542372881
"2833",2006-01-12,1,1,-121.5365208,38.63816052,2833,12721,4.49029297564419
"2834",2006-01-12,2,7,-121.42747,38.60154457,2834,12728,4.49117854622442
"2835",2006-01-12,1,5,-121.5002858,38.61058078,2835,12733,4.49135802469136
"2836",2006-01-12,2,1,-121.4295032,38.60240036,2836,12734,4.4901269393512
"2837",2006-01-12,1,7,-121.5152564,38.65603463,2837,12741,4.49101163200564
"2838",2006-01-12,3,3,-121.4799892,38.56907718,2838,12744,4.49048625792812
"2839",2006-01-12,5,7,-121.4289453,38.46712113,2839,12751,4.49137020077492
"2840",2006-01-12,3,4,-121.4963282,38.58076474,2840,12755,4.49119718309859
"2841",2006-01-12,3,9,-121.4943141,38.5796521,2841,12764,4.49278423090461
"2842",2006-01-12,4,2,-121.4912627,38.51063877,2842,12766,4.49190710767065
"2843",2006-01-12,3,3,-121.4736865,38.57381016,2843,12769,4.49138234259585
"2844",2006-01-12,2,4,-121.4576293,38.64444404,2844,12773,4.49120956399437
"2845",2006-01-12,6,8,-121.4650574,38.5392541,2845,12781,4.49244288224956
"2846",2006-01-12,4,1,-121.4739615,38.53366299,2846,12782,4.49121574139143
"2847",2006-01-12,3,5,-121.3867789,38.56143749,2847,12787,4.49139445029856
"2848",2006-01-12,1,5,-121.4931565,38.61112645,2848,12792,4.49157303370786
"2849",2006-01-12,2,5,-121.4593557,38.61302483,2849,12797,4.49175149175149
"2850",2006-01-12,3,8,-121.4810431,38.58431639,2850,12805,4.49298245614035
"2851",2006-01-12,6,5,-121.4352432,38.53951607,2851,12810,4.49316029463346
"2852",2006-01-12,5,1,-121.4558032,38.48648604,2852,12811,4.49193548387097
"2853",2006-01-12,4,7,-121.4816448,38.50487902,2853,12818,4.49281458114266
"2854",2006-01-12,5,5,-121.4309511,38.46831178,2854,12823,4.49299229152067
"2855",2006-01-12,6,5,-121.417634,38.53506546,2855,12828,4.49316987740806
"2856",2006-01-12,3,7,-121.4281865,38.5584422,2856,12835,4.49404761904762
"2857",2006-01-12,3,7,-121.4622017,38.58138835,2857,12842,4.49492474623731
"2858",2006-01-12,5,2,-121.4281268,38.47295223,2858,12844,4.49405178446466
"2859",2006-01-12,5,7,-121.4289878,38.47316243,2859,12851,4.49492829660721
"2860",2006-01-12,2,8,-121.4585133,38.60643063,2860,12859,4.49615384615385
"2861",2006-01-12,4,1,-121.4768614,38.50718879,2861,12860,4.49493184201328
"2862",2006-01-12,3,4,-121.4886003,38.57007662,2862,12864,4.49475890985325
"2863",2006-01-12,1,5,-121.5391236,38.62817573,2863,12869,4.49493538246595
"2864",2006-01-12,3,5,-121.4281865,38.5584422,2864,12874,4.49511173184358
"2865",2006-01-12,3,7,-121.4881721,38.56783954,2865,12881,4.49598603839442
"2866",2006-01-12,5,5,-121.490763,38.47337967,2866,12886,4.49616189811584
"2867",2006-01-12,3,4,-121.4648897,38.57188611,2867,12890,4.49598883850715
"2868",2006-01-12,4,7,-121.4830552,38.51087148,2868,12897,4.49686192468619
"2869",2006-01-12,4,6,-121.4908928,38.53212412,2869,12903,4.49738584872778
"2870",2006-01-12,3,4,-121.4885404,38.56769563,2870,12907,4.49721254355401
"2871",2006-01-12,3,7,-121.4881721,38.56783954,2871,12914,4.49808429118774
"2872",2006-01-12,3,5,-121.3791447,38.55494654,2872,12919,4.49825905292479
"2873",2006-01-12,6,2,-121.4231443,38.51639588,2873,12921,4.49738948833971
"2874",2006-01-12,3,5,-121.4984557,38.56725848,2874,12926,4.49756437021573
"2875",2006-01-12,3,8,-121.4996207,38.58316799,2875,12934,4.49878260869565
"2876",2006-01-12,4,3,-121.4830084,38.50913035,2876,12937,4.49826147426982
"2877",2006-01-12,6,7,-121.415863,38.51054067,2877,12944,4.49913103927702
"2878",2006-01-12,2,7,-121.4265847,38.60719135,2878,12951,4.5
"2879",2006-01-12,6,5,-121.4219971,38.54023875,2879,12956,4.50017367141369
"2880",2006-01-12,3,7,-121.4830358,38.57629892,2880,12963,4.50104166666667
"2881",2006-01-12,5,1,-121.4549812,38.4875421,2881,12964,4.4998264491496
"2882",2006-01-12,3,1,-121.4043498,38.55342594,2882,12965,4.49861207494795
"2883",2006-01-12,3,2,-121.4789247,38.57499264,2883,12967,4.49774540409296
"2884",2006-01-12,6,7,-121.4134015,38.52472204,2884,12974,4.49861303744799
"2885",2006-01-12,3,2,-121.4494805,38.57251407,2885,12976,4.49774696707106
"2886",2006-01-12,6,2,-121.4723384,38.55555724,2886,12978,4.4968814968815
"2887",2006-01-12,4,6,-121.4760613,38.53955707,2887,12984,4.49740214755802
"2888",2006-01-12,1,5,-121.4812614,38.61923472,2888,12989,4.49757617728532
"2889",2006-01-12,4,5,-121.5043072,38.53502991,2889,12994,4.49775008653513
"2890",2006-01-12,1,5,-121.5102971,38.62504244,2890,12999,4.49792387543253
"2891",2006-01-12,5,7,-121.4434966,38.46792527,2891,13006,4.49878934624697
"2892",2006-01-12,1,8,-121.4975722,38.6649083,2892,13014,4.5
"2893",2006-01-12,4,4,-121.4986029,38.52042714,2893,13018,4.49982716902869
"2894",2006-01-12,2,7,-121.4590851,38.62009985,2894,13025,4.50069108500346
"2895",2006-01-12,2,1,-121.4508169,38.61384139,2895,13026,4.49948186528497
"2896",2006-01-12,1,8,-121.5194346,38.64299789,2896,13034,4.50069060773481
"2897",2006-01-12,5,1,-121.4503108,38.47429277,2897,13035,4.4994822229893
"2898",2006-01-12,2,3,-121.4505252,38.60990782,2898,13038,4.49896480331263
"2899",2006-01-12,4,5,-121.5131614,38.56133787,2899,13043,4.49913763366678
"2900",2006-01-12,3,3,-121.4919558,38.57874934,2900,13046,4.49862068965517
"2901",2006-01-12,5,7,-121.4271773,38.4706931,2901,13053,4.4994829369183
"2902",2006-01-12,2,3,-121.4640303,38.65741543,2902,13056,4.49896623018608
"2903",2006-01-12,1,5,-121.5045087,38.68025769,2903,13061,4.49913882190837
"2904",2006-01-12,3,7,-121.4909275,38.56647048,2904,13068,4.5
"2905",2006-01-12,4,7,-121.47576,38.54106323,2905,13075,4.50086058519793
"2906",2006-01-12,1,5,-121.513771,38.6237857,2906,13080,4.50103234686855
"2907",2006-01-12,5,4,-121.4370963,38.47078576,2907,13084,4.50085999312005
"2908",2006-01-12,4,3,-121.4764341,38.55735796,2908,13087,4.50034387895461
"2909",2006-01-12,6,4,-121.4684595,38.54438547,2909,13091,4.50017188037126
"2910",2006-01-12,1,5,-121.4982215,38.62989225,2910,13096,4.50034364261168
"2911",2006-01-12,5,5,-121.4368769,38.47425283,2911,13101,4.50051528684301
"2912",2006-01-12,2,3,-121.4352848,38.62704884,2912,13104,4.5
"2913",2006-01-12,1,8,-121.4962227,38.61701338,2913,13112,4.50120151047031
"2914",2006-01-12,6,6,-121.4722717,38.55464254,2914,13118,4.50171585449554
"2915",2006-01-13,4,5,-121.543006,38.49162504,2915,13123,4.50188679245283
"2916",2006-01-13,2,7,-121.4202994,38.61624915,2916,13130,4.50274348422497
"2917",2006-01-13,5,7,-121.4133413,38.45718227,2917,13137,4.50359958861844
"2918",2006-01-13,3,5,-121.4883415,38.587136,2918,13142,4.50376970527759
"2919",2006-01-13,3,7,-121.4590954,38.57307015,2919,13149,4.50462487153135
"2920",2006-01-13,1,7,-121.5027127,38.66253327,2920,13156,4.50547945205479
"2921",2006-01-13,5,5,-121.4882258,38.48429181,2921,13161,4.50564875042794
"2922",2006-01-13,3,8,-121.4848294,38.57642774,2922,13169,4.50684462696783
"2923",2006-01-13,3,7,-121.4934856,38.57957708,2923,13176,4.50769757098871
"2924",2006-01-13,1,7,-121.5088602,38.62376224,2924,13183,4.50854993160055
"2925",2006-01-13,3,4,-121.4279854,38.55124956,2925,13187,4.50837606837607
"2926",2006-01-13,2,3,-121.4598647,38.63592285,2926,13190,4.50786056049214
"2927",2006-01-13,5,3,-121.4901998,38.48916359,2927,13193,4.50734540485138
"2928",2006-01-13,4,2,-121.4803182,38.55415996,2928,13195,4.50648907103825
"2929",2006-01-13,2,5,-121.4292113,38.6069517,2929,13200,4.50665756230795
"2930",2006-01-13,6,1,-121.4278431,38.54238493,2930,13201,4.50546075085324
"2931",2006-01-13,5,5,-121.4392522,38.45421346,2931,13206,4.50562947799386
"2932",2006-01-13,3,3,-121.5056982,38.59667389,2932,13209,4.50511596180082
"2933",2006-01-13,5,3,-121.4189709,38.47433721,2933,13212,4.50460279577225
"2934",2006-01-13,4,7,-121.4843929,38.55211324,2934,13219,4.5054533060668
"2935",2006-01-13,6,3,-121.4702136,38.55442719,2935,13222,4.50494037478705
"2936",2006-01-13,3,3,-121.4882605,38.58135818,2936,13225,4.50442779291553
"2937",2006-01-13,6,8,-121.4559025,38.54041688,2937,13233,4.50561797752809
"2938",2006-01-13,2,2,-121.4598647,38.63592285,2938,13235,4.50476514635807
"2939",2006-01-13,3,8,-121.4875031,38.57626112,2939,13243,4.50595440626063
"2940",2006-01-13,3,5,-121.437248,38.5694759,2940,13248,4.50612244897959
"2941",2006-01-13,5,5,-121.4270617,38.44809336,2941,13253,4.50629037742265
"2942",2006-01-13,2,1,-121.4581226,38.61502086,2942,13254,4.50509857239973
"2943",2006-01-13,2,5,-121.4605654,38.60671206,2943,13259,4.50526673462453
"2944",2006-01-13,3,1,-121.4978243,38.58390985,2944,13260,4.50407608695652
"2945",2006-01-13,5,1,-121.4260625,38.47381246,2945,13261,4.50288624787776
"2946",2006-01-13,4,5,-121.4803518,38.49576768,2946,13266,4.5030549898167
"2947",2006-01-13,4,5,-121.4990502,38.54485146,2947,13271,4.50322361723787
"2948",2006-01-13,3,7,-121.4747386,38.58245916,2948,13278,4.50407055630936
"2949",2006-01-13,6,7,-121.4248698,38.50958079,2949,13285,4.50491692099017
"2950",2006-01-13,3,2,-121.4829418,38.58395418,2950,13287,4.50406779661017
"2951",2006-01-13,2,5,-121.4387627,38.63437819,2951,13292,4.50423585225347
"2952",2006-01-13,4,7,-121.4804997,38.53403303,2952,13299,4.50508130081301
"2953",2006-01-13,4,7,-121.5465242,38.49549417,2953,13306,4.50592617676939
"2954",2006-01-13,6,7,-121.4169769,38.53505117,2954,13313,4.50677048070413
"2955",2006-01-13,3,4,-121.4800392,38.57517889,2955,13317,4.50659898477157
"2956",2006-01-13,4,4,-121.4871361,38.53047919,2956,13321,4.50642760487145
"2957",2006-01-13,5,7,-121.4407368,38.46308183,2957,13328,4.50727088265134
"2958",2006-01-13,2,7,-121.4330466,38.59773592,2958,13335,4.50811359026369
"2959",2006-01-13,3,3,-121.505613,38.594323,2959,13338,4.50760392024333
"2960",2006-01-13,4,5,-121.4807291,38.53085426,2960,13343,4.50777027027027
"2961",2006-01-13,6,6,-121.4155102,38.53272069,2961,13349,4.50827423167849
"2962",2006-01-13,5,2,-121.4859396,38.48934244,2962,13351,4.50742741390952
"2963",2006-01-13,1,7,-121.4836208,38.66946015,2963,13358,4.50826864664192
"2964",2006-01-13,1,7,-121.4836208,38.66946015,2964,13365,4.50910931174089
"2965",2006-01-13,5,5,-121.5051808,38.49221076,2965,13370,4.50927487352445
"2966",2006-01-13,2,5,-121.4303406,38.59657483,2966,13375,4.50944032366824
"2967",2006-01-13,1,3,-121.5048798,38.65407136,2967,13378,4.50893158072127
"2968",2006-01-13,1,2,-121.4746566,38.61972393,2968,13380,4.50808625336927
"2969",2006-01-13,2,4,-121.4369555,38.61364029,2969,13384,4.50791512293702
"2970",2006-01-13,6,6,-121.4254625,38.54146972,2970,13390,4.50841750841751
"2971",2006-01-13,4,1,-121.52225,38.52594221,2971,13391,4.50723662066644
"2972",2006-01-13,2,6,-121.4578044,38.60992565,2972,13397,4.50773889636608
"2973",2006-01-13,1,7,-121.4973299,38.61236933,2973,13404,4.50857719475277
"2974",2006-01-13,3,7,-121.4974538,38.58137649,2974,13411,4.50941492938803
"2975",2006-01-13,5,6,-121.4613879,38.46910016,2975,13417,4.50991596638655
"2976",2006-01-13,4,2,-121.4827348,38.49575914,2976,13419,4.50907258064516
"2977",2006-01-13,5,5,-121.4213101,38.46714906,2977,13424,4.50923748740343
"2978",2006-01-13,1,4,-121.5093788,38.62825953,2978,13428,4.50906648757555
"2979",2006-01-13,2,6,-121.4578044,38.60992565,2979,13434,4.50956696878147
"2980",2006-01-13,6,5,-121.4725782,38.53540586,2980,13439,4.50973154362416
"2981",2006-01-13,2,6,-121.3815598,38.63862878,2981,13445,4.51023146595102
"2982",2006-01-13,3,7,-121.4994153,38.56756469,2982,13452,4.51106639839034
"2983",2006-01-13,6,6,-121.4253159,38.50843245,2983,13458,4.51156553804894
"2984",2006-01-13,2,5,-121.4487142,38.62053425,2984,13463,4.51172922252011
"2985",2006-01-13,2,7,-121.446116,38.62968232,2985,13470,4.51256281407035
"2986",2006-01-13,4,6,-121.4990149,38.52199137,2986,13476,4.51306095110516
"2987",2006-01-13,6,5,-121.406008,38.51048773,2987,13481,4.513223970539
"2988",2006-01-13,4,6,-121.5346969,38.50298477,2988,13487,4.51372155287818
"2989",2006-01-13,2,7,-121.4569435,38.62692723,2989,13494,4.51455336232854
"2990",2006-01-13,6,2,-121.4684935,38.55155803,2990,13496,4.51371237458194
"2991",2006-01-13,5,1,-121.4923774,38.47575377,2991,13497,4.51253761283852
"2992",2006-01-13,6,6,-121.423686,38.51293868,2992,13503,4.51303475935829
"2993",2006-01-13,5,7,-121.4087833,38.44924246,2993,13510,4.51386568660207
"2994",2006-01-13,3,7,-121.405123,38.56931527,2994,13517,4.51469605878424
"2995",2006-01-13,3,4,-121.490702,38.58532585,2995,13521,4.51452420701169
"2996",2006-01-13,3,4,-121.4952908,38.579563,2996,13525,4.51435246995995
"2997",2006-01-13,2,6,-121.4629401,38.61435132,2997,13531,4.51484818151485
"2998",2006-01-13,2,7,-121.4254704,38.60650209,2998,13538,4.51567711807872
"2999",2006-01-13,5,7,-121.489991,38.47387328,2999,13545,4.51650550183394
"3000",2006-01-13,4,6,-121.5346969,38.50298477,3000,13551,4.517
"3001",2006-01-13,3,6,-121.5071707,38.57498453,3001,13557,4.51749416861046
"3002",2006-01-13,1,1,-121.5016083,38.62715545,3002,13558,4.51632245169887
"3003",2006-01-13,1,5,-121.4948028,38.61536788,3003,13563,4.51648351648352
"3004",2006-01-13,4,7,-121.4974104,38.55973557,3004,13570,4.51731025299601
"3005",2006-01-13,6,5,-121.4647075,38.54395353,3005,13575,4.51747088186356
"3006",2006-01-13,1,8,-121.5161468,38.65847399,3006,13583,4.51862940785096
"3007",2006-01-13,5,5,-121.4946743,38.4828813,3007,13588,4.51878949118723
"3008",2006-01-13,4,6,-121.4909981,38.53599087,3008,13594,4.51928191489362
"3009",2006-01-13,2,5,-121.4567993,38.60955023,3009,13599,4.51944167497507
"3010",2006-01-13,4,7,-121.5034231,38.56361407,3010,13606,4.5202657807309
"3011",2006-01-13,6,1,-121.4467668,38.54672494,3011,13607,4.51909664563268
"3012",2006-01-13,6,5,-121.4499592,38.53038804,3012,13612,4.51925630810093
"3013",2006-01-13,2,5,-121.4471043,38.61689369,3013,13617,4.51941586458679
"3014",2006-01-13,5,6,-121.4592772,38.49601155,3014,13623,4.51990710019907
"3015",2006-01-13,1,2,-121.4982033,38.61357858,3015,13625,4.51907131011609
"3016",2006-01-13,3,8,-121.4960471,38.56905759,3016,13633,4.52022546419098
"3017",2006-01-13,3,6,-121.43864,38.55792771,3017,13639,4.52071594298972
"3018",2006-01-13,1,6,-121.4959999,38.63020663,3018,13645,4.52120609675282
"3019",2006-01-13,3,3,-121.4878161,38.5857662,3019,13648,4.52070221927791
"3020",2006-01-13,4,7,-121.5270526,38.49695939,3020,13655,4.52152317880795
"3021",2006-01-13,5,5,-121.4352402,38.4470984,3021,13660,4.52168156239656
"3022",2006-01-13,4,8,-121.5119988,38.5017242,3022,13668,4.52283256121774
"3023",2006-01-13,4,7,-121.5168951,38.48767733,3023,13675,4.52365200132319
"3024",2006-01-13,3,5,-121.3807559,38.54861475,3024,13680,4.52380952380952
"3025",2006-01-13,1,4,-121.5291633,38.63577485,3025,13684,4.52363636363636
"3026",2006-01-13,5,5,-121.428888,38.46599501,3026,13689,4.52379378717779
"3027",2006-01-13,2,4,-121.4460758,38.63304591,3027,13693,4.52362074661381
"3028",2006-01-13,3,1,-121.4739148,38.58364167,3028,13694,4.5224570673712
"3029",2006-01-13,5,3,-121.4859396,38.48934244,3029,13697,4.52195444040938
"3030",2006-01-13,3,6,-121.4318092,38.55848201,3030,13703,4.52244224422442
"3031",2006-01-13,3,7,-121.3940644,38.54818818,3031,13710,4.52325965028044
"3032",2006-01-13,1,2,-121.5047935,38.63726864,3032,13712,4.52242744063324
"3033",2006-01-13,4,2,-121.4770327,38.5544225,3033,13714,4.52159577975602
"3034",2006-01-13,1,7,-121.4734424,38.632001,3034,13721,4.522412656559
"3035",2006-01-13,1,4,-121.4822785,38.62377281,3035,13725,4.52224052718287
"3036",2006-01-13,2,2,-121.4572426,38.61062598,3036,13727,4.52140974967062
"3037",2006-01-13,1,4,-121.4745819,38.64316291,3037,13731,4.52123806387883
"3038",2006-01-13,4,1,-121.4739615,38.53366299,3038,13732,4.52007899934167
"3039",2006-01-13,4,5,-121.5008546,38.51382466,3039,13737,4.52023692003949
"3040",2006-01-13,4,3,-121.5208252,38.48407454,3040,13740,4.51973684210526
"3041",2006-01-13,5,7,-121.4542781,38.48445234,3041,13747,4.52055244985202
"3042",2006-01-13,3,7,-121.4732633,38.5662212,3042,13754,4.52136752136752
"3043",2006-01-13,6,5,-121.4422011,38.51127205,3043,13759,4.52152481104174
"3044",2006-01-13,3,2,-121.4979339,38.58026647,3044,13761,4.52069645203679
"3045",2006-01-13,5,7,-121.4647903,38.48535273,3045,13768,4.52151067323481
"3046",2006-01-13,5,5,-121.4941276,38.48608342,3046,13773,4.52166776099803
"3047",2006-01-13,6,1,-121.409083,38.51055016,3047,13774,4.52051197899573
"3048",2006-01-13,6,2,-121.4560858,38.54434994,3048,13776,4.51968503937008
"3049",2006-01-13,3,7,-121.4992858,38.58054142,3049,13783,4.52049852410626
"3050",2006-01-13,1,7,-121.4765537,38.6359308,3050,13790,4.52131147540984
"3051",2006-01-13,4,1,-121.4779426,38.55336668,3051,13791,4.52015732546706
"3052",2006-01-13,6,8,-121.4608452,38.54517402,3052,13799,4.52129750982962
"3053",2006-01-13,5,1,-121.4678848,38.49625742,3053,13800,4.52014412053718
"3054",2006-01-13,1,7,-121.4749646,38.62780937,3054,13807,4.52095612311722
"3055",2006-01-13,3,2,-121.4827304,38.59284733,3055,13809,4.52013093289689
"3056",2006-01-13,6,1,-121.4538401,38.54675579,3056,13810,4.51897905759162
"3057",2006-01-13,6,1,-121.4684935,38.55155803,3057,13811,4.51782793588485
"3058",2006-01-13,6,7,-121.447484,38.53719443,3058,13818,4.51863963374755
"3059",2006-01-13,3,2,-121.496949,38.59839361,3059,13820,4.51781627983001
"3060",2006-01-13,4,1,-121.479014,38.53881527,3060,13821,4.51666666666667
"3061",2006-01-13,4,7,-121.4873957,38.55128083,3061,13828,4.51747794838288
"3062",2006-01-13,3,7,-121.3888282,38.56348858,3062,13835,4.51828870019595
"3063",2006-01-13,6,7,-121.3837155,38.51970186,3063,13842,4.51909892262488
"3064",2006-01-13,3,4,-121.4945586,38.57971632,3064,13846,4.51892950391645
"3065",2006-01-13,2,1,-121.4343771,38.59542759,3065,13847,4.51778140293638
"3066",2006-01-13,5,6,-121.428879,38.45400615,3066,13853,4.51826484018265
"3067",2006-01-13,4,3,-121.4712477,38.52718667,3067,13856,4.51776980762961
"3068",2006-01-13,3,5,-121.4782896,38.57717555,3068,13861,4.51792698826597
"3069",2006-01-13,5,4,-121.460842,38.49515388,3069,13865,4.51775822743565
"3070",2006-01-13,1,5,-121.5360931,38.65114978,3070,13870,4.51791530944625
"3071",2006-01-13,6,6,-121.4214843,38.52801945,3071,13876,4.51839791598828
"3072",2006-01-13,6,5,-121.4095593,38.54169721,3072,13881,4.5185546875
"3073",2006-01-13,1,7,-121.5119979,38.65731154,3073,13888,4.51936218678815
"3074",2006-01-13,6,1,-121.4633315,38.54700614,3074,13889,4.51821730644112
"3075",2006-01-13,2,2,-121.4258496,38.62764502,3075,13891,4.51739837398374
"3076",2006-01-13,6,5,-121.4385165,38.53274676,3076,13896,4.51755526657997
"3077",2006-01-13,5,2,-121.5050118,38.48684997,3077,13898,4.51673708157296
"3078",2006-01-13,6,5,-121.4565022,38.5397085,3078,13903,4.51689408706953
"3079",2006-01-13,6,1,-121.4538401,38.54675579,3079,13904,4.51575186748944
"3080",2006-01-13,4,3,-121.5412748,38.5076709,3080,13907,4.51525974025974
"3081",2006-01-13,4,3,-121.4803518,38.49576768,3081,13910,4.51476793248945
"3082",2006-01-13,6,9,-121.4310098,38.51796159,3082,13919,4.51622323166775
"3083",2006-01-13,1,3,-121.5139237,38.61063608,3083,13922,4.51573143042491
"3084",2006-01-13,6,5,-121.4383522,38.51585289,3084,13927,4.51588845654994
"3085",2006-01-13,1,5,-121.4755625,38.61124309,3085,13932,4.5160453808752
"3086",2006-01-13,2,4,-121.4392211,38.6183743,3086,13936,4.51587815942968
"3087",2006-01-13,2,4,-121.4572426,38.61062598,3087,13940,4.51571104632329
"3088",2006-01-13,6,2,-121.4705253,38.53362535,3088,13942,4.51489637305699
"3089",2006-01-13,1,5,-121.5096441,38.65941872,3089,13947,4.51505341534477
"3090",2006-01-13,1,5,-121.5040184,38.63344024,3090,13952,4.51521035598705
"3091",2006-01-13,6,7,-121.4105978,38.53830301,3091,13959,4.51601423487544
"3092",2006-01-13,5,5,-121.4284849,38.43822872,3092,13964,4.51617076326003
"3093",2006-01-13,3,6,-121.4922174,38.5803294,3093,13970,4.51665050113159
"3094",2006-01-13,6,7,-121.4456482,38.52823386,3094,13977,4.51745313510019
"3095",2006-01-13,6,7,-121.4278799,38.54826969,3095,13984,4.51825525040388
"3096",2006-01-13,1,2,-121.5055312,38.63589608,3096,13986,4.51744186046512
"3097",2006-01-13,5,1,-121.4653782,38.49596852,3097,13987,4.51630610268001
"3098",2006-01-13,2,7,-121.4483391,38.63010482,3098,13994,4.51710781149129
"3099",2006-01-13,2,6,-121.4537964,38.60820707,3099,14000,4.51758631816715
"3100",2006-01-13,5,4,-121.4576662,38.49280772,3100,14004,4.51741935483871
"3101",2006-01-13,3,7,-121.4386015,38.57837934,3101,14011,4.51821992905514
"3102",2006-01-13,6,1,-121.4684935,38.55155803,3102,14012,4.5170857511283
"3103",2006-01-13,3,8,-121.4761983,38.57423893,3103,14020,4.51820818562681
"3104",2006-01-13,6,1,-121.4637484,38.53944575,3104,14021,4.51707474226804
"3105",2006-01-13,6,6,-121.4181141,38.50576856,3105,14027,4.51755233494364
"3106",2006-01-13,6,6,-121.4181141,38.50576856,3106,14033,4.51802962009015
"3107",2006-01-13,3,5,-121.4738686,38.56191557,3107,14038,4.51818474412617
"3108",2006-01-13,1,5,-121.4939808,38.61184675,3108,14043,4.51833976833977
"3109",2006-01-13,6,5,-121.415719,38.54522407,3109,14048,4.51849469282728
"3110",2006-01-13,3,5,-121.5062054,38.57142168,3110,14053,4.51864951768489
"3111",2006-01-13,3,4,-121.4568029,38.57279305,3111,14057,4.51848280295725
"3112",2006-01-13,3,3,-121.4798128,38.58032651,3112,14060,4.51799485861183
"3113",2006-01-13,3,5,-121.4278597,38.55514819,3113,14065,4.51814969482814
"3114",2006-01-13,4,7,-121.5188739,38.48642794,3114,14072,4.5189466923571
"3115",2006-01-13,3,1,-121.4852542,38.56796664,3115,14073,4.51781701444623
"3116",2006-01-13,3,7,-121.4772314,38.57598179,3116,14080,4.5186136071887
"3117",2006-01-13,2,7,-121.4495674,38.60840673,3117,14087,4.51940968880334
"3118",2006-01-13,3,7,-121.4749592,38.57483194,3118,14094,4.52020525978191
"3119",2006-01-13,3,3,-121.4688257,38.57128915,3119,14097,4.51971785828791
"3120",2006-01-13,4,1,-121.5103071,38.55784124,3120,14098,4.51858974358974
"3121",2006-01-13,3,6,-121.5032275,38.58165678,3121,14104,4.51906440243512
"3122",2006-01-13,5,5,-121.4347565,38.4702938,3122,14109,4.51921844971172
"3123",2006-01-13,2,6,-121.4307875,38.6247477,3123,14115,4.51969260326609
"3124",2006-01-13,5,2,-121.4223876,38.47038918,3124,14117,4.51888604353393
"3125",2006-01-13,6,7,-121.4245898,38.53436161,3125,14124,4.51968
"3126",2006-01-13,6,5,-121.4437535,38.52868334,3126,14129,4.51983365323097
"3127",2006-01-13,2,4,-121.423349,38.59664183,3127,14133,4.51966741285577
"3128",2006-01-13,5,1,-121.4347565,38.4702938,3128,14134,4.51854219948849
"3129",2006-01-13,6,7,-121.4674364,38.55451604,3129,14141,4.51933525087887
"3130",2006-01-13,5,5,-121.4128268,38.44541326,3130,14146,4.51948881789137
"3131",2006-01-13,6,2,-121.4424164,38.53651384,3131,14148,4.51868412647716
"3132",2006-01-13,2,2,-121.424418,38.63369822,3132,14150,4.51787994891443
"3133",2006-01-13,2,5,-121.4186959,38.64721815,3133,14155,4.51803383338653
"3134",2006-01-13,6,5,-121.4520729,38.5296347,3134,14160,4.51818761965539
"3135",2006-01-13,5,7,-121.4292267,38.45682246,3135,14167,4.51897926634769
"3136",2006-01-13,6,7,-121.4428571,38.52439535,3136,14174,4.51977040816327
"3137",2006-01-13,6,9,-121.4682014,38.53538583,3137,14183,4.52119859738604
"3138",2006-01-13,2,5,-121.432273,38.62985421,3138,14188,4.52135117909496
"3139",2006-01-13,3,7,-121.4858657,38.56756845,3139,14195,4.5221408091749
"3140",2006-01-13,2,4,-121.4265596,38.61118933,3140,14199,4.52197452229299
"3141",2006-01-13,3,7,-121.3994469,38.54805148,3141,14206,4.52276345113021
"3142",2006-01-13,2,7,-121.4258245,38.59642896,3142,14213,4.52355187778485
"3143",2006-01-13,6,4,-121.4443436,38.52652786,3143,14217,4.52338530066815
"3144",2006-01-13,3,8,-121.467125,38.57606751,3144,14225,4.52449109414758
"3145",2006-01-13,3,8,-121.491759,38.57739748,3145,14233,4.52559618441971
"3146",2006-01-13,5,1,-121.4583909,38.48340351,3146,14234,4.52447552447552
"3147",2006-01-13,5,1,-121.427181,38.46849636,3147,14235,4.52335557673975
"3148",2006-01-13,5,1,-121.4803338,38.48046996,3148,14236,4.52223634053367
"3149",2006-01-13,6,6,-121.4394225,38.51975733,3149,14242,4.52270562083201
"3150",2006-01-13,3,7,-121.4986248,38.58052209,3150,14249,4.52349206349206
"3151",2006-01-13,6,4,-121.4321517,38.52160558,3151,14253,4.52332592827674
"3152",2006-01-13,1,5,-121.5055312,38.63589608,3152,14258,4.52347715736041
"3153",2006-01-13,4,2,-121.5212972,38.50539044,3153,14260,4.52267681573105
"3154",2006-01-13,2,5,-121.4286533,38.6071494,3154,14265,4.52282815472416
"3155",2006-01-13,3,5,-121.4584329,38.56956597,3155,14270,4.5229793977813
"3156",2006-01-13,3,7,-121.4722683,38.57779356,3156,14277,4.52376425855513
"3157",2006-01-13,1,1,-121.4717582,38.61030866,3157,14278,4.52264808362369
"3158",2006-01-13,3,5,-121.4322547,38.55700138,3158,14283,4.52279924002533
"3159",2006-01-13,4,3,-121.528402,38.51325652,3159,14286,4.52231718898386
"3160",2006-01-13,1,1,-121.4955733,38.61282301,3160,14287,4.52120253164557
"3161",2006-01-13,3,5,-121.498235,38.56929775,3161,14292,4.52135400189813
"3162",2006-01-13,3,7,-121.4827802,38.57005626,3162,14299,4.52213788741303
"3163",2006-01-13,1,2,-121.5005902,38.62857895,3163,14301,4.52134049952577
"3164",2006-01-13,4,3,-121.5181672,38.48295688,3164,14304,4.52085967130215
"3165",2006-01-13,5,1,-121.42717,38.47421612,3165,14305,4.51974723538705
"3166",2006-01-13,1,2,-121.5096149,38.62701937,3166,14307,4.51895135818067
"3167",2006-01-13,2,5,-121.4442244,38.61278296,3167,14312,4.51910325228923
"3168",2006-01-13,6,5,-121.4121729,38.50709227,3168,14317,4.51925505050505
"3169",2006-01-13,6,5,-121.4186854,38.53003193,3169,14322,4.5194067529189
"3170",2006-01-13,4,7,-121.5467673,38.50067395,3170,14329,4.52018927444795
"3171",2006-01-13,5,7,-121.4449392,38.48049217,3171,14336,4.52097130242826
"3172",2006-01-13,4,1,-121.4915761,38.54220472,3172,14337,4.51986128625473
"3173",2006-01-13,1,5,-121.4914125,38.61422446,3173,14342,4.52001260636622
"3174",2006-01-13,3,4,-121.4098486,38.55069168,3174,14346,4.51984877126654
"3175",2006-01-13,6,1,-121.4705214,38.53273565,3175,14347,4.51874015748032
"3176",2006-01-13,5,3,-121.480413,38.49167924,3176,14350,4.51826196473552
"3177",2006-01-13,2,1,-121.446158,38.62427027,3177,14351,4.51715454831602
"3178",2006-01-13,2,5,-121.4164461,38.63547066,3178,14356,4.51730648206419
"3179",2006-01-13,2,5,-121.4165233,38.63972452,3179,14361,4.51745832022649
"3180",2006-01-13,3,5,-121.4634009,38.56613196,3180,14366,4.51761006289308
"3181",2006-01-13,3,5,-121.4893761,38.58287612,3181,14371,4.51776171015404
"3182",2006-01-13,3,3,-121.4870264,38.57736287,3182,14374,4.51728472658705
"3183",2006-01-13,2,5,-121.4617562,38.63533304,3183,14379,4.51743638077286
"3184",2006-01-13,4,3,-121.5110987,38.52447597,3184,14382,4.51695979899498
"3185",2006-01-13,5,1,-121.4597801,38.49696125,3185,14383,4.51585557299843
"3186",2006-01-13,2,7,-121.4158235,38.63667849,3186,14390,4.51663527934714
"3187",2006-01-14,5,5,-121.489486,38.4800247,3187,14395,4.51678694697207
"3188",2006-01-14,5,5,-121.4443027,38.47519492,3188,14400,4.51693851944793
"3189",2006-01-14,5,7,-121.428118,38.46487634,3189,14407,4.51771715271245
"3190",2006-01-14,4,7,-121.478831,38.54998768,3190,14414,4.51849529780564
"3191",2006-01-14,1,7,-121.4978558,38.61273956,3191,14421,4.51927295518646
"3192",2006-01-14,6,5,-121.4267168,38.53374334,3192,14426,4.51942355889724
"3193",2006-01-14,2,5,-121.4643148,38.62748602,3193,14431,4.51957406827435
"3194",2006-01-14,4,7,-121.5183094,38.51522221,3194,14438,4.52035065748278
"3195",2006-01-14,3,7,-121.4149051,38.55706875,3195,14445,4.52112676056338
"3196",2006-01-14,5,4,-121.4366375,38.4749354,3196,14449,4.52096370463079
"3197",2006-01-14,1,5,-121.5096149,38.62701937,3197,14454,4.52111354394745
"3198",2006-01-14,2,8,-121.4540554,38.62419792,3198,14462,4.52220137585991
"3199",2006-01-14,3,7,-121.4803755,38.57559229,3199,14469,4.52297592997812
"3200",2006-01-14,4,1,-121.4972545,38.56201402,3200,14470,4.521875
"3201",2006-01-14,3,8,-121.4656992,38.5786943,3201,14478,4.52296157450797
"3202",2006-01-14,5,5,-121.4592772,38.49601155,3202,14483,4.52311055590256
"3203",2006-01-14,3,3,-121.4977991,38.57009493,3203,14486,4.52263502965969
"3204",2006-01-14,3,7,-121.4862799,38.57221093,3204,14493,4.52340823970037
"3205",2006-01-14,2,5,-121.4223802,38.61041617,3205,14498,4.52355694227769
"3206",2006-01-14,1,4,-121.4894179,38.62248644,3206,14502,4.52339363693075
"3207",2006-01-14,3,3,-121.4971183,38.57091301,3207,14505,4.52291861552853
"3208",2006-01-14,3,2,-121.4860325,38.59053897,3208,14507,4.52213216957606
"3209",2006-01-14,2,5,-121.4106565,38.6264676,3209,14512,4.52228108444998
"3210",2006-01-14,3,7,-121.411779,38.55575132,3210,14519,4.52305295950156
"3211",2006-01-14,3,7,-121.4832569,38.56895726,3211,14526,4.52382435378387
"3212",2006-01-14,4,6,-121.4780917,38.51433105,3212,14532,4.52428393524284
"3213",2006-01-14,2,5,-121.4286413,38.60034763,3213,14537,4.52443199502023
"3214",2006-01-14,2,8,-121.4648925,38.61955018,3214,14545,4.52551337896702
"3215",2006-01-14,1,8,-121.532093,38.68226149,3215,14553,4.52659409020218
"3216",2006-01-14,3,3,-121.4791288,38.59206781,3216,14556,4.52611940298507
"3217",2006-01-14,4,8,-121.4839016,38.50304384,3217,14564,4.52719925396332
"3218",2006-01-14,4,5,-121.5384407,38.48548348,3218,14569,4.52734617775016
"3219",2006-01-14,4,5,-121.5384407,38.48548348,3219,14574,4.52749301025163
"3220",2006-01-14,3,7,-121.411779,38.55575132,3220,14581,4.52826086956522
"3221",2006-01-14,6,1,-121.395812,38.52514501,3221,14582,4.52716547656007
"3222",2006-01-14,5,7,-121.4362195,38.45265,3222,14589,4.52793296089385
"3223",2006-01-14,6,5,-121.3967577,38.52491379,3223,14594,4.52807942910332
"3224",2006-01-14,3,8,-121.407649,38.54901914,3224,14602,4.52915632754342
"3225",2006-01-14,2,7,-121.4654703,38.62511063,3225,14609,4.52992248062016
"3226",2006-01-14,6,8,-121.4646263,38.52495123,3226,14617,4.53099814011159
"3227",2006-01-14,1,1,-121.5079782,38.66533462,3227,14618,4.52990393554385
"3228",2006-01-14,6,5,-121.4661137,38.55416121,3228,14623,4.53004956629492
"3229",2006-01-14,4,4,-121.4784137,38.50326361,3229,14627,4.52988541344069
"3230",2006-01-14,3,3,-121.4280648,38.55486637,3230,14630,4.52941176470588
"3231",2006-01-14,5,5,-121.4654193,38.48160193,3231,14635,4.52955741256577
"3232",2006-01-14,6,7,-121.4357076,38.50996368,3232,14642,4.53032178217822
"3233",2006-01-14,4,5,-121.5038535,38.49870196,3233,14647,4.53046705845964
"3234",2006-01-14,5,7,-121.4613559,38.49094674,3234,14654,4.53123067408782
"3235",2006-01-14,6,8,-121.4462065,38.53106486,3235,14662,4.5323029366306
"3236",2006-01-14,6,5,-121.4597019,38.54978463,3236,14667,4.53244746600742
"3237",2006-01-14,3,4,-121.484359,38.57665081,3237,14671,4.53228297806611
"3238",2006-01-14,6,4,-121.4597405,38.55069371,3238,14675,4.53211859172329
"3239",2006-01-14,6,4,-121.4489624,38.5313636,3239,14679,4.53195430688484
"3240",2006-01-14,1,3,-121.4755526,38.61354414,3240,14682,4.53148148148148
"3241",2006-01-14,2,4,-121.422119,38.60507125,3241,14686,4.53131749460043
"3242",2006-01-14,3,3,-121.4123944,38.55024332,3242,14689,4.5308451573103
"3243",2006-01-14,1,5,-121.4955828,38.61246333,3243,14694,4.53098982423682
"3244",2006-01-14,3,2,-121.4521612,38.57052225,3244,14696,4.53020961775586
"3245",2006-01-14,6,7,-121.4567845,38.54259307,3245,14703,4.53097072419106
"3246",2006-01-14,1,1,-121.4755923,38.60672341,3246,14704,4.52988293284042
"3247",2006-01-14,3,1,-121.4915999,38.57076808,3247,14705,4.52879581151832
"3248",2006-01-14,1,3,-121.5254763,38.65584901,3248,14708,4.52832512315271
"3249",2006-01-14,5,5,-121.4196158,38.46676162,3249,14713,4.5284702985534
"3250",2006-01-14,3,5,-121.409084,38.5695415,3250,14718,4.52861538461538
"3251",2006-01-14,2,1,-121.4481759,38.60777952,3251,14719,4.52752999077207
"3252",2006-01-14,2,1,-121.4262102,38.60284815,3252,14720,4.52644526445264
"3253",2006-01-14,5,5,-121.4798635,38.48268931,3253,14725,4.52659083922533
"3254",2006-01-14,1,5,-121.4729069,38.59789126,3254,14730,4.52673632452366
"3255",2006-01-14,2,8,-121.439235,38.62017846,3255,14738,4.52780337941628
"3256",2006-01-14,2,5,-121.4381004,38.6051444,3256,14743,4.5279484029484
"3257",2006-01-14,4,5,-121.4757979,38.55209111,3257,14748,4.52809333742708
"3258",2006-01-14,1,5,-121.4742524,38.63893542,3258,14753,4.52823818293432
"3259",2006-01-14,2,7,-121.4258885,38.59891162,3259,14760,4.52899662473151
"3260",2006-01-14,2,1,-121.4437606,38.62108722,3260,14761,4.52791411042945
"3261",2006-01-14,3,5,-121.493533,38.57191063,3261,14766,4.52805887764489
"3262",2006-01-14,3,5,-121.4771548,38.57545696,3262,14771,4.52820355610055
"3263",2006-01-14,3,5,-121.4771548,38.57545696,3263,14776,4.52834814587803
"3264",2006-01-14,6,8,-121.4546045,38.55426406,3264,14784,4.52941176470588
"3265",2006-01-14,2,1,-121.4660254,38.62484409,3265,14785,4.52833078101072
"3266",2006-01-14,1,5,-121.5151131,38.6235744,3266,14790,4.52847519902021
"3267",2006-01-14,2,6,-121.4435773,38.6176594,3267,14796,4.52892561983471
"3268",2006-01-14,2,1,-121.4648179,38.62482204,3268,14797,4.52784577723378
"3269",2006-01-14,1,1,-121.4792477,38.62322376,3269,14798,4.52676659528908
"3270",2006-01-14,6,7,-121.466685,38.53806713,3270,14805,4.52752293577982
"3271",2006-01-14,2,4,-121.4609044,38.60122175,3271,14809,4.52736166309997
"3272",2006-01-14,1,4,-121.5230056,38.61374104,3272,14813,4.52720048899756
"3273",2006-01-14,2,7,-121.4490916,38.61200165,3273,14820,4.52795600366636
"3274",2006-01-14,6,7,-121.4552803,38.54726509,3274,14827,4.52871105681124
"3275",2006-01-14,2,4,-121.4465194,38.60973497,3275,14831,4.52854961832061
"3276",2006-01-14,2,4,-121.423349,38.59664183,3276,14835,4.52838827838828
"3277",2006-01-14,6,4,-121.4453076,38.52573067,3277,14839,4.52822703692402
"3278",2006-01-14,4,6,-121.479014,38.53881527,3278,14845,4.52867602196461
"3279",2006-01-14,4,6,-121.479014,38.53881527,3279,14851,4.52912473315035
"3280",2006-01-14,1,6,-121.5062517,38.6142667,3280,14857,4.52957317073171
"3281",2006-01-14,4,5,-121.4843549,38.55447458,3281,14862,4.52971654983237
"3282",2006-01-14,3,4,-121.4352683,38.56418305,3282,14866,4.52955514929921
"3283",2006-01-14,2,4,-121.4252477,38.60027317,3283,14870,4.52939384709108
"3284",2006-01-14,3,1,-121.5052755,38.58245363,3284,14871,4.52831912302071
"3285",2006-01-14,4,3,-121.4980099,38.52224238,3285,14874,4.52785388127854
"3286",2006-01-14,3,3,-121.5059336,38.58239328,3286,14877,4.52738892270237
"3287",2006-01-14,2,7,-121.4429518,38.62783286,3287,14884,4.52814116215394
"3288",2006-01-14,3,7,-121.4853771,38.58390462,3288,14891,4.52889294403893
"3289",2006-01-14,3,1,-121.4671204,38.56919165,3289,14892,4.52782000608088
"3290",2006-01-14,5,7,-121.4145656,38.44243723,3290,14899,4.52857142857143
"3291",2006-01-14,5,7,-121.4346919,38.47889655,3291,14906,4.52932239440899
"3292",2006-01-14,2,7,-121.4276508,38.59994183,3292,14913,4.53007290400972
"3293",2006-01-14,1,4,-121.4765366,38.63872883,3293,14917,4.52991193440632
"3294",2006-01-14,1,6,-121.4807127,38.61576139,3294,14923,4.53035822707954
"3295",2006-01-14,3,4,-121.426754,38.57829932,3295,14927,4.53019726858877
"3296",2006-01-14,1,5,-121.4963523,38.68339134,3296,14932,4.53033980582524
"3297",2006-01-14,3,4,-121.4986248,38.58052209,3297,14936,4.53017895056112
"3298",2006-01-14,3,7,-121.474781,38.57385083,3298,14943,4.53092783505155
"3299",2006-01-14,2,5,-121.4421574,38.60767381,3299,14948,4.53107002121855
"3300",2006-01-14,1,5,-121.4745819,38.64316291,3300,14953,4.53121212121212
"3301",2006-01-14,4,7,-121.5396169,38.47644582,3301,14960,4.53196001211754
"3302",2006-01-14,2,7,-121.4252477,38.60027317,3302,14967,4.53270745003028
"3303",2006-01-14,6,1,-121.4724294,38.55270462,3303,14968,4.53163790493491
"3304",2006-01-14,5,7,-121.468655,38.4753863,3304,14975,4.53238498789346
"3305",2006-01-14,5,4,-121.4588661,38.46264365,3305,14979,4.532223903177
"3306",2006-01-14,5,7,-121.4762942,38.49256682,3306,14986,4.5329703569268
"3307",2006-01-14,2,4,-121.4258271,38.6017616,3307,14990,4.53280919262171
"3308",2006-01-14,3,5,-121.3921168,38.54654137,3308,14995,4.53295042321644
"3309",2006-01-14,6,7,-121.457865,38.54118672,3309,15002,4.53369598065881
"3310",2006-01-14,6,5,-121.4410972,38.52326926,3310,15007,4.53383685800604
"3311",2006-01-14,2,4,-121.42747,38.60154457,3311,15011,4.53367562669888
"3312",2006-01-14,3,3,-121.5060581,38.59623882,3312,15014,4.53321256038647
"3313",2006-01-14,5,1,-121.4489194,38.4726221,3313,15015,4.53214609115605
"3314",2006-01-14,5,1,-121.4271773,38.4706931,3314,15016,4.53108026554013
"3315",2006-01-14,3,3,-121.4961452,38.57944041,3315,15019,4.53061840120664
"3316",2006-01-14,3,2,-121.5014414,38.58243993,3316,15021,4.52985524728589
"3317",2006-01-14,6,4,-121.4552803,38.54726509,3317,15025,4.52969550798915
"3318",2006-01-14,3,1,-121.4910941,38.5857779,3318,15026,4.5286317058469
"3319",2006-01-14,5,5,-121.4429194,38.46399853,3319,15031,4.52877372702621
"3320",2006-01-14,3,3,-121.4925953,38.57884551,3320,15034,4.52831325301205
"3321",2006-01-14,2,5,-121.4267744,38.61798936,3321,15039,4.52845528455285
"3322",2006-01-14,5,6,-121.4347708,38.45744833,3322,15045,4.52889825406382
"3323",2006-01-14,2,2,-121.42747,38.60154457,3323,15047,4.52813722539874
"3324",2006-01-14,4,4,-121.5024975,38.55692374,3324,15051,4.52797833935018
"3325",2006-01-14,4,7,-121.5136804,38.48261682,3325,15058,4.52872180451128
"3326",2006-01-14,6,4,-121.4387788,38.51849931,3326,15062,4.52856283824414
"3327",2006-01-14,3,7,-121.4102219,38.55502121,3327,15069,4.52930568079351
"3328",2006-01-14,1,5,-121.4755462,38.61584246,3328,15074,4.52944711538461
"3329",2006-01-14,3,3,-121.4976906,38.57905171,3329,15077,4.52898768398919
"3330",2006-01-14,5,2,-121.4724244,38.48149132,3330,15079,4.52822822822823
"3331",2006-01-14,3,5,-121.4692575,38.57201606,3331,15084,4.52836985890123
"3332",2006-01-14,4,1,-121.4827348,38.49575914,3332,15085,4.52731092436975
"3333",2006-01-14,2,6,-121.4217991,38.64150838,3333,15091,4.52775277527753
"3334",2006-01-14,1,6,-121.4904838,38.61538191,3334,15097,4.52819436112777
"3335",2006-01-14,5,1,-121.4847037,38.49502927,3335,15098,4.52713643178411
"3336",2006-01-14,6,1,-121.4708274,38.54097213,3336,15099,4.52607913669065
"3337",2006-01-14,1,4,-121.541883,38.65798545,3337,15103,4.525921486365
"3338",2006-01-14,2,5,-121.42747,38.60154457,3338,15108,4.52606351108448
"3339",2006-01-14,3,1,-121.4758065,38.5613889,3339,15109,4.52500748727164
"3340",2006-01-14,5,1,-121.4348784,38.47431447,3340,15110,4.52395209580838
"3341",2006-01-14,2,4,-121.4195162,38.62002366,3341,15114,4.52379527087698
"3342",2006-01-14,3,6,-121.4360287,38.57948169,3342,15120,4.52423698384201
"3343",2006-01-14,2,7,-121.4465194,38.60973497,3343,15127,4.52497756506132
"3344",2006-01-14,5,6,-121.4598457,38.47674042,3344,15133,4.52541866028708
"3345",2006-01-14,1,6,-121.5097637,38.67460145,3345,15139,4.52585949177877
"3346",2006-01-14,4,5,-121.519688,38.53369985,3346,15144,4.52600119545726
"3347",2006-01-14,6,5,-121.4224962,38.51053004,3347,15149,4.52614281446071
"3348",2006-01-14,5,9,-121.4571234,38.48424606,3348,15158,4.52747909199522
"3349",2006-01-14,5,1,-121.4176675,38.45768744,3349,15159,4.52642579874589
"3350",2006-01-14,5,5,-121.4198979,38.47115382,3350,15164,4.5265671641791
"3351",2006-01-14,2,5,-121.4545528,38.6383446,3351,15169,4.52670844524023
"3352",2006-01-14,5,5,-121.503973,38.48904227,3352,15174,4.52684964200477
"3353",2006-01-14,2,7,-121.4303283,38.63228581,3353,15181,4.52758723531166
"3354",2006-01-14,3,4,-121.4707578,38.57394234,3354,15185,4.52742993440668
"3355",2006-01-14,4,5,-121.5048587,38.5225465,3355,15190,4.52757078986587
"3356",2006-01-14,3,7,-121.3837794,38.54995993,3356,15197,4.52830750893921
"3357",2006-01-14,3,5,-121.442584,38.56206295,3357,15202,4.52844801906464
"3358",2006-01-14,4,7,-121.5111808,38.53801653,3358,15209,4.52918403811793
"3359",2006-01-14,2,4,-121.4549025,38.6026847,3359,15213,4.52902649598095
"3360",2006-01-14,3,1,-121.4927485,38.56418287,3360,15214,4.52797619047619
"3361",2006-01-14,6,7,-121.4428571,38.52439535,3361,15221,4.52871169294853
"3362",2006-01-14,3,1,-121.4876958,38.57815667,3362,15222,4.52766210588935
"3363",2006-01-14,3,5,-121.493943,38.57920289,3363,15227,4.52780255724056
"3364",2006-01-14,2,8,-121.4221827,38.64471755,3364,15235,4.52883472057075
"3365",2006-01-14,5,7,-121.4097064,38.44613053,3365,15242,4.5295690936107
"3366",2006-01-14,2,2,-121.4249976,38.5974436,3366,15244,4.52881758764112
"3367",2006-01-14,2,7,-121.423349,38.59664183,3367,15251,4.52955152955153
"3368",2006-01-14,6,7,-121.4171599,38.52891214,3368,15258,4.53028503562945
"3369",2006-01-14,2,7,-121.4213955,38.60797834,3369,15265,4.53101810626299
"3370",2006-01-14,6,5,-121.3906942,38.52517858,3370,15270,4.53115727002967
"3371",2006-01-14,3,7,-121.4135687,38.5732988,3371,15277,4.53188964698902
"3372",2006-01-14,6,8,-121.414415,38.52048468,3372,15285,4.53291814946619
"3373",2006-01-14,3,7,-121.4543479,38.56951933,3373,15292,4.53364957011562
"3374",2006-01-14,1,4,-121.4979968,38.65732863,3374,15296,4.5334914048607
"3375",2006-01-14,6,5,-121.4120905,38.52855972,3375,15301,4.53362962962963
"3376",2006-01-14,1,7,-121.4945809,38.61408181,3376,15308,4.53436018957346
"3377",2006-01-14,4,7,-121.5340814,38.48913456,3377,15315,4.53509031684927
"3378",2006-01-14,5,4,-121.4840434,38.49502083,3378,15319,4.53493191237419
"3379",2006-01-14,3,1,-121.4884229,38.58506592,3379,15320,4.53388576501924
"3380",2006-01-14,6,1,-121.3912953,38.52560462,3380,15321,4.53284023668639
"3381",2006-01-14,3,7,-121.4672697,38.5810603,3381,15328,4.53356994971902
"3382",2006-01-14,6,7,-121.4649893,38.53295733,3382,15335,4.53429923122413
"3383",2006-01-14,3,5,-121.4795434,38.56546427,3383,15340,4.53443689033402
"3384",2006-01-14,6,2,-121.4224962,38.51053004,3384,15342,4.53368794326241
"3385",2006-01-14,2,3,-121.4568936,38.64404243,3385,15345,4.53323485967504
"3386",2006-01-14,3,3,-121.4692124,38.5738419,3386,15348,4.53278204370939
"3387",2006-01-14,1,5,-121.5352159,38.61169279,3387,15353,4.53291998819014
"3388",2006-01-14,5,3,-121.4503108,38.47429277,3388,15356,4.53246753246753
"3389",2006-01-14,6,1,-121.4704591,38.55385441,3389,15357,4.5314251991738
"3390",2006-01-14,1,2,-121.4755341,38.620343,3390,15359,4.5306784660767
"3391",2006-01-14,6,5,-121.4671318,38.55128541,3391,15364,4.53081686818048
"3392",2006-01-14,3,3,-121.4817242,38.56954354,3392,15367,4.53036556603774
"3393",2006-01-14,3,5,-121.4825556,38.57740339,3393,15372,4.53050397877984
"3394",2006-01-15,3,3,-121.4720913,38.56720714,3394,15375,4.53005303476724
"3395",2006-01-15,6,4,-121.4104237,38.50055075,3395,15379,4.52989690721649
"3396",2006-01-15,4,5,-121.5182786,38.51513147,3396,15384,4.53003533568905
"3397",2006-01-15,4,5,-121.4801778,38.50095123,3397,15389,4.53017368266117
"3398",2006-01-15,4,5,-121.473272,38.53092764,3398,15394,4.53031194820483
"3399",2006-01-15,2,4,-121.4202559,38.60826097,3399,15398,4.53015592821418
"3400",2006-01-15,5,5,-121.4938617,38.4723306,3400,15403,4.53029411764706
"3401",2006-01-15,1,4,-121.4952127,38.65733301,3401,15407,4.53013819464863
"3402",2006-01-15,4,4,-121.4784413,38.52532188,3402,15411,4.5299823633157
"3403",2006-01-15,5,2,-121.4196575,38.47581524,3403,15413,4.5292389068469
"3404",2006-01-15,5,3,-121.4385947,38.47745747,3404,15416,4.52878965922444
"3405",2006-01-15,4,7,-121.5118863,38.49057248,3405,15423,4.5295154185022
"3406",2006-01-15,5,5,-121.428371,38.45814178,3406,15428,4.52965355255432
"3407",2006-01-15,4,6,-121.4909877,38.49920896,3407,15434,4.53008511887291
"3408",2006-01-15,3,5,-121.5012154,38.57523636,3408,15439,4.53022300469484
"3409",2006-01-15,6,9,-121.4243203,38.54783739,3409,15448,4.53153417424465
"3410",2006-01-15,3,5,-121.4935219,38.57100991,3410,15453,4.5316715542522
"3411",2006-01-15,4,4,-121.4877811,38.55653827,3411,15457,4.53151568454999
"3412",2006-01-15,3,4,-121.5046071,38.58349423,3412,15461,4.53135990621336
"3413",2006-01-15,3,4,-121.4976906,38.57905171,3413,15465,4.53120421916203
"3414",2006-01-15,2,5,-121.4416613,38.6366219,3414,15470,4.53134153485647
"3415",2006-01-15,5,4,-121.479436,38.48191577,3415,15474,4.5311859443631
"3416",2006-01-15,6,5,-121.4566752,38.54454492,3416,15479,4.53132318501171
"3417",2006-01-15,3,7,-121.4902264,38.58432423,3417,15486,4.53204565408253
"3418",2006-01-15,3,5,-121.486753,38.5711174,3418,15491,4.53218256290228
"3419",2006-01-15,3,2,-121.4790719,38.57447707,3419,15493,4.53144194208833
"3420",2006-01-15,1,5,-121.4754412,38.62630675,3420,15498,4.53157894736842
"3421",2006-01-15,1,2,-121.5320925,38.68341203,3421,15500,4.53083893598363
"3422",2006-01-15,3,5,-121.4678719,38.57348427,3422,15505,4.53097603740503
"3423",2006-01-15,3,2,-121.4789156,38.57432259,3423,15507,4.53023663453111
"3424",2006-01-15,6,2,-121.4425904,38.52497346,3424,15509,4.5294976635514
"3425",2006-01-15,5,7,-121.4261836,38.46874129,3425,15516,4.53021897810219
"3426",2006-01-15,3,3,-121.4804664,38.58903956,3426,15519,4.52977232924693
"3427",2006-01-15,6,4,-121.4683357,38.53425511,3427,15523,4.52961774146484
"3428",2006-01-15,1,2,-121.5279355,38.62663415,3428,15525,4.52887981330222
"3429",2006-01-15,3,7,-121.4877027,38.56892211,3429,15532,4.52960046660834
"3430",2006-01-15,4,3,-121.5411563,38.4934822,3430,15535,4.52915451895044
"3431",2006-01-15,4,1,-121.5406076,38.49350199,3431,15536,4.52812591081317
"3432",2006-01-15,6,9,-121.4660623,38.55121732,3432,15545,4.5294289044289
"3433",2006-01-15,1,5,-121.4931565,38.61112645,3433,15550,4.52956597727935
"3434",2006-01-15,3,5,-121.4388587,38.55902715,3434,15555,4.52970297029703
"3435",2006-01-15,5,2,-121.4312631,38.46377975,3435,15557,4.52896652110626
"3436",2006-01-15,3,5,-121.4147524,38.55564283,3436,15562,4.5291036088475
"3437",2006-01-15,4,7,-121.4873195,38.50397344,3437,15569,4.52982251963922
"3438",2006-01-15,2,3,-121.4209449,38.62597578,3438,15572,4.52937754508435
"3439",2006-01-15,5,5,-121.4316068,38.45877009,3439,15577,4.5295143937191
"3440",2006-01-15,2,5,-121.3853268,38.64271559,3440,15582,4.5296511627907
"3441",2006-01-15,2,3,-121.4364722,38.62031333,3441,15585,4.52920662598082
"3442",2006-01-15,3,7,-121.4659619,38.57209976,3442,15592,4.52992446252179
"3443",2006-01-15,6,7,-121.3947713,38.50235087,3443,15599,4.53064188207958
"3444",2006-01-15,6,7,-121.406008,38.51048773,3444,15606,4.53135888501742
"3445",2006-01-15,3,4,-121.4845602,38.57640183,3445,15610,4.53120464441219
"3446",2006-01-15,6,7,-121.4085999,38.52077088,3446,15617,4.53192106790482
"3447",2006-01-15,1,5,-121.5377464,38.62839816,3447,15622,4.53205686103858
"3448",2006-01-15,6,6,-121.4155107,38.51472647,3448,15628,4.53248259860789
"3449",2006-01-15,4,7,-121.4890962,38.55650289,3449,15635,4.53319802841403
"3450",2006-01-15,5,3,-121.4393029,38.4628909,3450,15638,4.53275362318841
"3451",2006-01-15,4,5,-121.5122674,38.52123795,3451,15643,4.53288901767604
"3452",2006-01-15,3,7,-121.4738655,38.56803077,3452,15650,4.53360370799536
"3453",2006-01-15,2,7,-121.4219099,38.62007132,3453,15657,4.53431798436142
"3454",2006-01-15,1,5,-121.5051933,38.67297018,3454,15662,4.53445280833816
"3455",2006-01-15,2,6,-121.4251438,38.63095587,3455,15668,4.53487698986975
"3456",2006-01-15,2,5,-121.4447167,38.63179823,3456,15673,4.53501157407407
"3457",2006-01-15,1,5,-121.4799069,38.608676,3457,15678,4.53514608041655
"3458",2006-01-15,2,1,-121.4573294,38.6231314,3458,15679,4.53412377096588
"3459",2006-01-15,3,2,-121.4921151,38.57995276,3459,15681,4.53339115351258
"3460",2006-01-15,6,6,-121.4564089,38.55196871,3460,15687,4.53381502890173
"3461",2006-01-15,4,4,-121.5348293,38.48641086,3461,15691,4.53366079167871
"3462",2006-01-15,2,1,-121.4177667,38.62337866,3462,15692,4.53264009243212
"3463",2006-01-15,6,5,-121.4121889,38.52891445,3463,15697,4.53277505053422
"3464",2006-01-15,2,5,-121.4360584,38.62130809,3464,15702,4.53290993071594
"3465",2006-01-15,2,4,-121.4648139,38.62301794,3465,15706,4.53275613275613
"3466",2006-01-15,6,6,-121.4564089,38.55196871,3466,15712,4.533179457588
"3467",2006-01-15,3,1,-121.5035416,38.57071008,3467,15713,4.53216036919527
"3468",2006-01-15,1,2,-121.5016483,38.67151063,3468,15715,4.53143021914648
"3469",2006-01-15,2,4,-121.4265847,38.60719135,3469,15719,4.53127702507927
"3470",2006-01-15,6,2,-121.4531476,38.55545168,3470,15721,4.53054755043228
"3471",2006-01-15,3,2,-121.4667413,38.58295257,3471,15723,4.52981849611063
"3472",2006-01-15,4,1,-121.473272,38.53092764,3472,15724,4.52880184331797
"3473",2006-01-15,5,5,-121.4946499,38.48139564,3473,15729,4.52893751799597
"3474",2006-01-15,6,7,-121.4713923,38.53692719,3474,15736,4.52964881980426
"3475",2006-01-15,1,5,-121.4945578,38.62080376,3475,15741,4.52978417266187
"3476",2006-01-15,1,7,-121.5180813,38.60753682,3476,15748,4.53049482163406
"3477",2006-01-15,5,1,-121.460842,38.49515388,3477,15749,4.52947943629566
"3478",2006-01-15,5,7,-121.4589523,38.48077278,3478,15756,4.53018976423232
"3479",2006-01-15,3,3,-121.4541917,38.56388391,3479,15759,4.52974992814027
"3480",2006-01-15,4,1,-121.5444825,38.49676301,3480,15760,4.52873563218391
"3481",2006-01-15,6,4,-121.4666532,38.55309553,3481,15764,4.52858374030451
"3482",2006-01-15,4,4,-121.4827348,38.49575914,3482,15768,4.52843193566916
"3483",2006-01-15,2,3,-121.4540237,38.6370268,3483,15771,4.52799310938846
"3484",2006-01-15,2,4,-121.4576083,38.61960417,3484,15775,4.52784156142365
"3485",2006-01-15,5,1,-121.4487485,38.47531506,3485,15776,4.52682926829268
"3486",2006-01-15,6,8,-121.4161265,38.54284813,3486,15784,4.52782558806655
"3487",2006-01-15,4,4,-121.4761683,38.55308132,3487,15788,4.52767421852595
"3488",2006-01-15,6,5,-121.4608509,38.54581386,3488,15793,4.52780963302752
"3489",2006-01-15,6,1,-121.438141,38.5173841,3489,15794,4.5267985096016
"3490",2006-01-15,4,6,-121.479014,38.53881527,3490,15800,4.52722063037249
"3491",2006-01-15,1,7,-121.4769551,38.6308389,3491,15807,4.52792896018333
"3492",2006-01-15,6,1,-121.4473982,38.53517026,3492,15808,4.52691867124857
"3493",2006-01-15,1,1,-121.4956647,38.60930037,3493,15809,4.5259089607787
"3494",2006-01-15,3,7,-121.4852542,38.56796664,3494,15816,4.52661705781339
"3495",2006-01-15,1,3,-121.5245888,38.65711399,3495,15819,4.52618025751073
"3496",2006-01-15,2,4,-121.4360573,38.62985072,3496,15823,4.52602974828375
"3497",2006-01-15,6,4,-121.4456482,38.52823386,3497,15827,4.52587932513583
"3498",2006-01-15,2,2,-121.4315485,38.62852162,3498,15829,4.5251572327044
"3499",2006-01-15,3,6,-121.4917054,38.58541538,3499,15835,4.52557873678194
"3500",2006-01-15,2,4,-121.4481004,38.64330342,3500,15839,4.52542857142857
"3501",2006-01-15,3,7,-121.4852542,38.56796664,3501,15846,4.5261353898886
"3502",2006-01-15,5,3,-121.468608,38.47559478,3502,15849,4.52569960022844
"3503",2006-01-15,1,7,-121.4975768,38.62103382,3503,15856,4.52640593776763
"3504",2006-01-15,3,8,-121.4851233,38.58174244,3504,15864,4.52739726027397
"3505",2006-01-15,3,2,-121.4976565,38.5943272,3505,15866,4.52667617689016
"3506",2006-01-15,3,3,-121.4906312,38.58053662,3506,15869,4.52624073017684
"3507",2006-01-15,5,4,-121.4600086,38.48615702,3507,15873,4.52609067579127
"3508",2006-01-15,6,1,-121.4091682,38.53234249,3508,15874,4.52508551881414
"3509",2006-01-15,3,7,-121.4875031,38.57626112,3509,15881,4.52579082359647
"3510",2006-01-15,6,4,-121.4345667,38.50971647,3510,15885,4.52564102564103
"3511",2006-01-15,3,4,-121.3890139,38.54670352,3511,15889,4.52549131301623
"3512",2006-01-15,3,1,-121.4986248,38.58052209,3512,15890,4.5244874715262
"3513",2006-01-15,1,4,-121.4755625,38.61124309,3513,15894,4.52433817250213
"3514",2006-01-15,3,7,-121.4869337,38.58100632,3514,15901,4.52504268639727
"3515",2006-01-15,1,7,-121.5064571,38.63819563,3515,15908,4.52574679943101
"3516",2006-01-15,3,4,-121.4566551,38.57015351,3516,15912,4.52559726962457
"3517",2006-01-15,2,5,-121.4330439,38.64253051,3517,15917,4.52573215808928
"3518",2006-01-15,6,2,-121.3889165,38.51928736,3518,15919,4.52501421262081
"3519",2006-01-15,6,3,-121.4623494,38.53580637,3519,15922,4.52458084683149
"3520",2006-01-15,4,6,-121.4961221,38.52823131,3520,15928,4.525
"3521",2006-01-15,2,3,-121.4464036,38.63637281,3521,15931,4.52456688440784
"3522",2006-01-15,5,7,-121.4278127,38.46550091,3522,15938,4.52526973310619
"3523",2006-01-15,4,3,-121.5110596,38.5352893,3523,15941,4.52483678682941
"3524",2006-01-15,4,7,-121.4830057,38.55487496,3524,15948,4.5255391600454
"3525",2006-01-15,4,5,-121.5420917,38.50725401,3525,15953,4.52567375886525
"3526",2006-01-15,3,7,-121.4875031,38.57626112,3526,15960,4.5263754963131
"3527",2006-01-15,1,3,-121.4994973,38.62070164,3527,15963,4.52594272753048
"3528",2006-01-15,2,5,-121.42747,38.60154457,3528,15968,4.52607709750567
"3529",2006-01-15,6,5,-121.4471706,38.52935875,3529,15973,4.52621139132899
"3530",2006-01-15,6,2,-121.4733179,38.55408988,3530,15975,4.52549575070821
"3531",2006-01-15,4,5,-121.5246711,38.53190811,3531,15980,4.52563013310677
"3532",2006-01-15,6,7,-121.4390559,38.51481284,3532,15987,4.52633069082673
"3533",2006-01-15,1,3,-121.4860777,38.62165064,3533,15990,4.52589866968582
"3534",2006-01-15,6,2,-121.4425904,38.52497346,3534,15992,4.52518392756084
"3535",2006-01-15,2,5,-121.4619758,38.60994784,3535,15997,4.52531824611033
"3536",2006-01-15,3,5,-121.4852738,38.56671183,3536,16002,4.52545248868778
"3537",2006-01-15,3,5,-121.4854695,38.56623766,3537,16007,4.52558665535765
"3538",2006-01-15,2,8,-121.4269577,38.63568789,3538,16015,4.52656868287168
"3539",2006-01-15,6,1,-121.4274484,38.51052171,3539,16016,4.52557219553546
"3540",2006-01-15,4,7,-121.5176621,38.48376758,3540,16023,4.52627118644068
"3541",2006-01-15,2,1,-121.426719,38.62009248,3541,16024,4.52527534594747
"3542",2006-01-15,2,2,-121.4476589,38.60720316,3542,16026,4.52456239412761
"3543",2006-01-15,2,3,-121.4444058,38.62587375,3543,16029,4.52413209144793
"3544",2006-01-15,3,8,-121.4987233,38.56750128,3544,16037,4.52511286681716
"3545",2006-01-15,5,7,-121.4590752,38.47607779,3545,16044,4.52581100141044
"3546",2006-01-15,4,7,-121.4744954,38.49628491,3546,16051,4.52650874224478
"3547",2006-01-15,3,8,-121.4091389,38.54940296,3547,16059,4.52748801804342
"3548",2006-01-15,4,4,-121.528986,38.48247425,3548,16063,4.52733934611048
"3549",2006-01-15,2,9,-121.4550362,38.61220552,3549,16072,4.52859960552268
"3550",2006-01-15,2,8,-121.4514812,38.61119745,3550,16080,4.52957746478873
"3551",2006-01-15,5,3,-121.4936494,38.49391,3551,16083,4.52914671923402
"3552",2006-01-15,5,3,-121.4508469,38.47816161,3552,16086,4.52871621621622
"3553",2006-01-15,6,7,-121.4521135,38.52981887,3553,16093,4.52941176470588
"3554",2006-01-15,5,4,-121.4646725,38.48289456,3554,16097,4.52926280247608
"3555",2006-01-15,3,5,-121.4608338,38.57307276,3555,16102,4.52939521800281
"3556",2006-01-15,5,5,-121.438423,38.47397477,3556,16107,4.52952755905512
"3557",2006-01-15,2,1,-121.4219201,38.62226264,3557,16108,4.52853528254147
"3558",2006-01-15,3,5,-121.3885434,38.55265153,3558,16113,4.52866779089376
"3559",2006-01-15,6,3,-121.4284078,38.53255722,3559,16116,4.52823826917674
"3560",2006-01-15,3,3,-121.5045175,38.57120853,3560,16119,4.52780898876405
"3561",2006-01-15,5,5,-121.422141,38.4438703,3561,16124,4.52794158944117
"3562",2006-01-15,4,6,-121.4780917,38.51433105,3562,16130,4.52835485682201
"3563",2006-01-15,6,1,-121.4091152,38.51890626,3563,16131,4.52736458040977
"3564",2006-01-15,2,7,-121.4355115,38.59841797,3564,16138,4.52805836139169
"3565",2006-01-15,3,4,-121.4394758,38.55927178,3565,16142,4.52791023842917
"3566",2006-01-15,5,2,-121.4630104,38.48093723,3566,16144,4.52720134604599
"3567",2006-01-15,4,1,-121.4759018,38.55841823,3567,16145,4.52621250350435
"3568",2006-01-15,2,8,-121.4318973,38.64537244,3568,16153,4.52718609865471
"3569",2006-01-15,6,5,-121.4337511,38.50591483,3569,16158,4.52731857663211
"3570",2006-01-15,1,5,-121.5100872,38.63570949,3570,16163,4.52745098039216
"3571",2006-01-15,4,2,-121.4766494,38.50655626,3571,16165,4.5267432091851
"3572",2006-01-15,4,5,-121.5013574,38.51538378,3572,16170,4.52687569988802
"3573",2006-01-15,4,5,-121.4880681,38.51018807,3573,16175,4.52700811642877
"3574",2006-01-15,6,7,-121.4696737,38.55790108,3574,16182,4.52770005595971
"3575",2006-01-15,6,9,-121.4262201,38.53899388,3575,16191,4.52895104895105
"3576",2006-01-15,6,4,-121.4139997,38.51316736,3576,16195,4.52880313199105
"3577",2006-01-15,2,5,-121.4649745,38.61188115,3577,16200,4.52893486161588
"3578",2006-01-15,6,5,-121.4351262,38.5149777,3578,16205,4.5290665176076
"3579",2006-01-15,3,7,-121.4100658,38.55783227,3579,16212,4.52975691533948
"3580",2006-01-15,5,5,-121.4283609,38.47206919,3580,16217,4.52988826815642
"3581",2006-01-15,2,3,-121.4259795,38.59803885,3581,16220,4.52946104440101
"3582",2006-01-15,1,7,-121.4748364,38.64520155,3582,16227,4.53015075376884
"3583",2006-01-15,4,3,-121.4943793,38.53689812,3583,16230,4.52972369522746
"3584",2006-01-15,2,5,-121.4365076,38.63974929,3584,16235,4.52985491071429
"3585",2006-01-15,2,7,-121.4239904,38.59954474,3585,16242,4.53054393305439
"3586",2006-01-15,2,4,-121.4577943,38.64622418,3586,16246,4.53039598438371
"3587",2006-01-15,2,2,-121.4593589,38.61214339,3587,16248,4.52969054920546
"3588",2006-01-15,5,1,-121.4684313,38.48151147,3588,16249,4.52870680044593
"3589",2006-01-15,3,1,-121.496127,38.58102199,3589,16250,4.52772359988855
"3590",2006-01-15,3,2,-121.4831868,38.56221292,3590,16252,4.52701949860724
"3591",2006-01-15,1,5,-121.4827635,38.63121921,3591,16257,4.52715121136174
"3592",2006-01-15,4,1,-121.5346969,38.50298477,3592,16258,4.52616926503341
"3593",2006-01-15,1,5,-121.4939842,38.62419798,3593,16263,4.52630114110771
"3594",2006-01-15,5,1,-121.4869374,38.48225136,3594,16264,4.52531997774068
"3595",2006-01-15,6,5,-121.4214941,38.53759463,3595,16269,4.52545201668985
"3596",2006-01-15,6,7,-121.4664139,38.55142764,3596,16276,4.52614015572859
"3597",2006-01-15,5,5,-121.4189374,38.44925003,3597,16281,4.52627189324437
"3598",2006-01-15,3,1,-121.4758116,38.57925951,3598,16282,4.52529182879377
"3599",2006-01-15,5,4,-121.4562033,38.48945629,3599,16286,4.52514587385385
"3600",2006-01-15,3,6,-121.4146624,38.57386726,3600,16292,4.52555555555556
"3601",2006-01-15,3,5,-121.4760225,38.56912794,3601,16297,4.52568730908081
"3602",2006-01-15,3,5,-121.4685593,38.56713881,3602,16302,4.52581898945031
"3603",2006-01-15,1,4,-121.5028488,38.63449242,3603,16306,4.52567305023591
"3604",2006-01-15,3,4,-121.4966071,38.57991197,3604,16310,4.52552719200888
"3605",2006-01-15,6,6,-121.4554708,38.55117621,3605,16316,4.52593619972261
"3606",2006-01-15,6,5,-121.4280236,38.53338734,3606,16321,4.52606766500277
"3607",2006-01-15,2,4,-121.4360584,38.62130809,3607,16325,4.52592181868589
"3608",2006-01-16,4,2,-121.5193388,38.51182977,3608,16327,4.52522172949002
"3609",2006-01-16,4,4,-121.5340459,38.49457685,3609,16331,4.52507619839291
"3610",2006-01-16,3,5,-121.4692183,38.57540163,3610,16336,4.52520775623269
"3611",2006-01-16,4,7,-121.5001967,38.54839044,3611,16343,4.52589310440321
"3612",2006-01-16,4,2,-121.4813961,38.53191169,3612,16345,4.52519379844961
"3613",2006-01-16,4,7,-121.5192006,38.48201109,3613,16352,4.52587877110435
"3614",2006-01-16,1,4,-121.5049355,38.62034607,3614,16356,4.52573325954621
"3615",2006-01-16,1,4,-121.5359129,38.68098352,3615,16360,4.52558782849239
"3616",2006-01-16,6,5,-121.4627146,38.55649326,3616,16365,4.52571902654867
"3617",2006-01-16,4,6,-121.497206,38.52472122,3617,16371,4.52612662427426
"3618",2006-01-16,2,3,-121.4391121,38.60910072,3618,16374,4.5257048092869
"3619",2006-01-16,2,8,-121.4593506,38.61692679,3619,16382,4.52666482453717
"3620",2006-01-16,5,6,-121.4584189,38.47279606,3620,16388,4.52707182320442
"3621",2006-01-16,1,3,-121.5035046,38.62075458,3621,16391,4.52665009665838
"3622",2006-01-16,6,1,-121.4321886,38.53146922,3622,16392,4.52567642186637
"3623",2006-01-16,4,4,-121.4809351,38.54291261,3623,16396,4.52553132762904
"3624",2006-01-16,2,5,-121.4225359,38.60415069,3624,16401,4.52566225165563
"3625",2006-01-16,3,3,-121.489227,38.56706435,3625,16404,4.52524137931035
"3626",2006-01-16,2,1,-121.4625036,38.62025306,3626,16405,4.52426916712631
"3627",2006-01-16,3,6,-121.4976906,38.57905171,3627,16411,4.52467604080507
"3628",2006-01-16,2,7,-121.4296538,38.61332448,3628,16418,4.52535832414554
"3629",2006-01-16,6,5,-121.4099629,38.53643802,3629,16423,4.5254891154588
"3630",2006-01-16,2,5,-121.4577329,38.65844332,3630,16428,4.52561983471074
"3631",2006-01-16,6,5,-121.4134753,38.5395643,3631,16433,4.52575048196089
"3632",2006-01-16,6,2,-121.403778,38.53480542,3632,16435,4.52505506607929
"3633",2006-01-16,2,5,-121.4413756,38.62170181,3633,16440,4.5251857968621
"3634",2006-01-16,3,3,-121.4694175,38.56649196,3634,16443,4.52476609796368
"3635",2006-01-16,3,5,-121.3919084,38.55129902,3635,16448,4.52489683631362
"3636",2006-01-16,5,2,-121.4304273,38.4599725,3636,16450,4.52420242024202
"3637",2006-01-16,5,6,-121.4579047,38.46323227,3637,16456,4.52460819356613
"3638",2006-01-16,3,3,-121.4834494,38.5911563,3638,16459,4.5241891148983
"3639",2006-01-16,3,5,-121.4147524,38.55564283,3639,16464,4.52431986809563
"3640",2006-01-16,3,2,-121.4924554,38.57834239,3640,16466,4.52362637362637
"3641",2006-01-16,2,5,-121.4564165,38.64645937,3641,16471,4.52375720955781
"3642",2006-01-16,1,4,-121.4808309,38.6226048,3642,16475,4.52361339923119
"3643",2006-01-16,4,7,-121.4738395,38.53171831,3643,16482,4.52429316497392
"3644",2006-01-16,4,7,-121.4933982,38.54410192,3644,16489,4.52497255762898
"3645",2006-01-16,3,7,-121.4659563,38.57331893,3645,16496,4.52565157750343
"3646",2006-01-16,3,2,-121.4984909,38.57966477,3646,16498,4.52495885902359
"3647",2006-01-16,6,5,-121.4206325,38.52744677,3647,16503,4.52508911434055
"3648",2006-01-16,4,3,-121.4743742,38.54029357,3648,16506,4.52467105263158
"3649",2006-01-16,4,7,-121.5281194,38.52958544,3649,16513,4.52534941079748
"3650",2006-01-16,3,5,-121.4906436,38.57929276,3650,16518,4.52547945205479
"3651",2006-01-16,6,5,-121.4021408,38.53952825,3651,16523,4.52560942207614
"3652",2006-01-16,6,3,-121.466534,38.55078839,3652,16526,4.52519167579409
"3653",2006-01-16,3,2,-121.4975806,38.58176147,3653,16528,4.52450041062141
"3654",2006-01-16,6,7,-121.4473209,38.52800022,3654,16535,4.52517788724685
"3655",2006-01-16,5,2,-121.4356632,38.44968715,3655,16537,4.52448700410397
"3656",2006-01-16,4,3,-121.5437781,38.50749407,3656,16540,4.52407002188184
"3657",2006-01-16,2,5,-121.4164146,38.63248017,3657,16545,4.52420016406891
"3658",2006-01-16,2,6,-121.4346488,38.61940652,3658,16551,4.52460360852925
"3659",2006-01-16,3,4,-121.487703,38.5766684,3659,16555,4.5244602350369
"3660",2006-01-16,3,1,-121.4762781,38.56099013,3660,16556,4.52349726775956
"3661",2006-01-16,3,2,-121.5027369,38.582786,3661,16558,4.52280797596285
"3662",2006-01-16,4,3,-121.5054972,38.56107472,3662,16561,4.52239213544511
"3663",2006-01-16,2,5,-121.4211729,38.59875634,3663,16566,4.52252252252252
"3664",2006-01-16,6,1,-121.4186088,38.54158377,3664,16567,4.52156113537118
"3665",2006-01-16,3,3,-121.4885667,38.57037029,3665,16570,4.52114597544338
"3666",2006-01-16,3,1,-121.4776149,38.56134765,3666,16571,4.52018548827059
"3667",2006-01-16,4,3,-121.487909,38.56161882,3667,16574,4.51977092991546
"3668",2006-01-16,6,7,-121.3708954,38.5255861,3668,16581,4.52044711014177
"3669",2006-01-16,3,1,-121.4583296,38.57948658,3669,16582,4.51948759880076
"3670",2006-01-16,3,7,-121.4290494,38.56729391,3670,16589,4.52016348773842
"3671",2006-01-16,5,9,-121.4286823,38.45720146,3671,16598,4.52138381912286
"3672",2006-01-16,2,6,-121.3815598,38.63862878,3672,16604,4.52178649237473
"3673",2006-01-16,3,4,-121.4274875,38.58017843,3673,16608,4.52164443234413
"3674",2006-01-16,5,1,-121.4592772,38.49601155,3674,16609,4.52068590092542
"3675",2006-01-16,2,5,-121.4308265,38.60058081,3675,16614,4.52081632653061
"3676",2006-01-16,2,6,-121.4021042,38.62987269,3676,16620,4.52121871599565
"3677",2006-01-16,2,2,-121.4414625,38.62982199,3677,16622,4.52053304324177
"3678",2006-01-16,5,6,-121.4626458,38.48575193,3678,16628,4.52093529091898
"3679",2006-01-16,2,3,-121.4461937,38.61112011,3679,16631,4.52052188094591
"3680",2006-01-16,3,5,-121.4987407,38.56900613,3680,16636,4.52065217391304
"3681",2006-01-16,4,6,-121.5169453,38.48697183,3681,16642,4.52105406139636
"3682",2006-01-16,4,6,-121.5169453,38.48697183,3682,16648,4.52145573058121
"3683",2006-01-16,5,4,-121.4230482,38.44870771,3683,16652,4.52131414607657
"3684",2006-01-16,4,5,-121.4847038,38.49647089,3684,16657,4.521444082519
"3685",2006-01-16,2,6,-121.4465233,38.60833456,3685,16663,4.52184531886024
"3686",2006-01-16,3,4,-121.4787324,38.59556161,3686,16667,4.52170374389582
"3687",2006-01-16,4,4,-121.4992887,38.56068556,3687,16671,4.52156224572823
"3688",2006-01-16,5,4,-121.4312015,38.47591105,3688,16675,4.52142082429501
"3689",2006-01-16,3,5,-121.466365,38.5804026,3689,16680,4.52155055570615
"3690",2006-01-16,4,5,-121.47576,38.54106323,3690,16685,4.52168021680217
"3691",2006-01-16,4,7,-121.506875,38.54843831,3691,16692,4.52235166621512
"3692",2006-01-16,3,3,-121.4392594,38.57167967,3692,16695,4.52193932827736
"3693",2006-01-16,4,7,-121.4807365,38.52647452,3693,16702,4.52261034389385
"3694",2006-01-16,6,8,-121.414923,38.53057039,3694,16710,4.52355170546833
"3695",2006-01-16,3,5,-121.5022303,38.59723293,3695,16715,4.52368064952639
"3696",2006-01-16,6,2,-121.4560858,38.54434994,3696,16717,4.52299783549784
"3697",2006-01-16,5,1,-121.4608988,38.47049831,3697,16718,4.5220449012713
"3698",2006-01-16,3,1,-121.4984909,38.57966477,3698,16719,4.52109248242293
"3699",2006-01-16,5,6,-121.4705051,38.4934631,3699,16725,4.52149229521492
"3700",2006-01-16,3,7,-121.4986248,38.58052209,3700,16732,4.52216216216216
"3701",2006-01-16,2,5,-121.4301916,38.60032506,3701,16737,4.52229127262902
"3702",2006-01-16,1,4,-121.533925,38.683359,3702,16741,4.52215018908698
"3703",2006-01-16,2,1,-121.4258271,38.6017616,3703,16742,4.52119902781528
"3704",2006-01-16,3,3,-121.4279854,38.55124956,3704,16745,4.52078833693305
"3705",2006-01-16,5,3,-121.4321414,38.4635644,3705,16748,4.52037786774629
"3706",2006-01-16,2,1,-121.4243752,38.63075984,3706,16749,4.51942795466811
"3707",2006-01-16,2,5,-121.4292813,38.60477176,3707,16754,4.51955759374157
"3708",2006-01-16,4,5,-121.4920591,38.50823683,3708,16759,4.51968716289105
"3709",2006-01-16,5,1,-121.4591171,38.46962227,3709,16760,4.51873820436775
"3710",2006-01-16,5,1,-121.4590392,38.46930612,3710,16761,4.5177897574124
"3711",2006-01-16,1,5,-121.4765366,38.63872883,3711,16766,4.51791969819456
"3712",2006-01-16,2,6,-121.4329623,38.60086039,3712,16772,4.51831896551724
"3713",2006-01-16,5,7,-121.4281268,38.47295223,3713,16779,4.51898734177215
"3714",2006-01-16,3,5,-121.4915974,38.57945897,3714,16784,4.5191168551427
"3715",2006-01-16,2,3,-121.4573294,38.6231314,3715,16787,4.51870794078062
"3716",2006-01-16,6,7,-121.4703152,38.54120868,3716,16794,4.51937567276642
"3717",2006-01-16,4,1,-121.4869088,38.53341084,3717,16795,4.51842884046274
"3718",2006-01-16,3,1,-121.4278339,38.55443686,3718,16796,4.51748251748252
"3719",2006-01-16,6,7,-121.4429168,38.5118137,3719,16803,4.51815004033342
"3720",2006-01-16,4,7,-121.4843549,38.55447458,3720,16810,4.51881720430108
"3721",2006-01-16,1,5,-121.5429538,38.65975805,3721,16815,4.51894651975275
"3722",2006-01-16,6,3,-121.4091401,38.53954773,3722,16818,4.51853842020419
"3723",2006-01-16,5,3,-121.4133413,38.45718227,3723,16821,4.51813053988719
"3724",2006-01-16,4,5,-121.5427657,38.51006027,3724,16826,4.51825993555317
"3725",2006-01-16,2,5,-121.4484964,38.61294068,3725,16831,4.51838926174497
"3726",2006-01-16,4,3,-121.4981519,38.55226434,3726,16834,4.51798174986581
"3727",2006-01-16,5,8,-121.4466002,38.46223959,3727,16842,4.51891601824524
"3728",2006-01-16,2,7,-121.4677651,38.62531066,3728,16849,4.51958154506438
"3729",2006-01-16,5,6,-121.4357127,38.45006084,3729,16855,4.51997854652722
"3730",2006-01-16,6,3,-121.427517,38.52507559,3730,16858,4.51957104557641
"3731",2006-01-16,6,1,-121.4443436,38.52652786,3731,16859,4.51862771374967
"3732",2006-01-16,5,5,-121.4945099,38.49130787,3732,16864,4.51875669882101
"3733",2006-01-16,6,7,-121.4624578,38.54508816,3733,16871,4.51942137690865
"3734",2006-01-16,5,7,-121.4854736,38.49049366,3734,16878,4.52008569898232
"3735",2006-01-16,3,3,-121.4854695,38.56623766,3735,16881,4.51967871485944
"3736",2006-01-16,5,5,-121.4720466,38.49479094,3736,16886,4.51980728051392
"3737",2006-01-16,3,7,-121.4803637,38.57768464,3737,16893,4.52047096601552
"3738",2006-01-16,6,1,-121.443515,38.52565067,3738,16894,4.5195291599786
"3739",2006-01-16,1,6,-121.5099935,38.62643059,3739,16900,4.51992511366676
"3740",2006-01-16,4,6,-121.5208027,38.49002489,3740,16906,4.52032085561497
"3741",2006-01-16,4,5,-121.4794398,38.51254677,3741,16911,4.52044907778669
"3742",2006-01-16,3,1,-121.465437,38.56326638,3742,16912,4.51950828433993
"3743",2006-01-16,4,5,-121.4805639,38.55451804,3743,16917,4.5196366550895
"3744",2006-01-16,5,6,-121.4491964,38.46478375,3744,16923,4.52003205128205
"3745",2006-01-16,6,5,-121.4471706,38.52935875,3745,16928,4.52016021361816
"3746",2006-01-16,5,6,-121.4597707,38.47094887,3746,16934,4.52055525894287
"3747",2006-01-16,4,7,-121.499694,38.55974271,3747,16941,4.52121697357886
"3748",2006-01-16,4,5,-121.47208,38.524299,3748,16946,4.5213447171825
"3749",2006-01-16,3,1,-121.4096655,38.54915301,3749,16947,4.52040544145105
"3750",2006-01-16,3,4,-121.4622017,38.58138835,3750,16951,4.52026666666667
"3751",2006-01-16,5,8,-121.4988184,38.47827244,3751,16959,4.52119434817382
"3752",2006-01-16,2,7,-121.4529368,38.62764703,3752,16966,4.52185501066098
"3753",2006-01-16,3,1,-121.465437,38.56326638,3753,16967,4.52091660005329
"3754",2006-01-16,5,3,-121.4328092,38.44720182,3754,16970,4.52051145444859
"3755",2006-01-16,5,7,-121.4291343,38.47188629,3755,16977,4.52117177097204
"3756",2006-01-16,3,3,-121.4771101,38.5681965,3756,16980,4.52076677316294
"3757",2006-01-16,3,5,-121.4738655,38.56803077,3757,16985,4.52089433058291
"3758",2006-01-16,3,5,-121.4754991,38.56848028,3758,16990,4.52102182011708
"3759",2006-01-16,2,1,-121.4507993,38.61202624,3759,16991,4.52008512902368
"3760",2006-01-16,2,2,-121.4461619,38.61655968,3760,16993,4.51941489361702
"3761",2006-01-16,5,5,-121.4810272,38.48312565,3761,16998,4.51954267482053
"3762",2006-01-16,6,7,-121.4144333,38.52506502,3762,17005,4.52020202020202
"3763",2006-01-16,1,4,-121.4978994,38.62741952,3763,17009,4.52006377889981
"3764",2006-01-16,4,5,-121.5069832,38.48064434,3764,17014,4.5201912858661
"3765",2006-01-16,5,4,-121.4561046,38.48728104,3765,17018,4.52005312084993
"3766",2006-01-16,4,5,-121.5061214,38.56285126,3766,17023,4.52018056293149
"3767",2006-01-16,4,5,-121.5312703,38.49904974,3767,17028,4.52030793735068
"3768",2006-01-16,1,5,-121.531759,38.631823,3768,17033,4.52043524416136
"3769",2006-01-16,4,7,-121.4807302,38.51099562,3769,17040,4.5210931281507
"3770",2006-01-16,3,4,-121.4976906,38.57905171,3770,17044,4.5209549071618
"3771",2006-01-16,3,4,-121.486043,38.58373458,3771,17048,4.52081675948024
"3772",2006-01-16,2,7,-121.4242543,38.5976184,3772,17055,4.52147401908802
"3773",2006-01-16,3,5,-121.4679847,38.56820709,3773,17060,4.52160084813146
"3774",2006-01-16,2,3,-121.4349119,38.64495332,3774,17063,4.52119766825649
"3775",2006-01-16,6,8,-121.4681974,38.53450711,3775,17071,4.52211920529801
"3776",2006-01-16,5,8,-121.4549812,38.4875421,3776,17079,4.52304025423729
"3777",2006-01-16,2,6,-121.4448838,38.61574625,3777,17085,4.52343129467832
"3778",2006-01-16,3,1,-121.5011657,38.58184562,3778,17086,4.52249867654844
"3779",2006-01-16,6,3,-121.4214978,38.52506487,3779,17089,4.52209579253771
"3780",2006-01-16,4,5,-121.4837511,38.51708866,3780,17094,4.52222222222222
"3781",2006-01-16,3,1,-121.411779,38.55575132,3781,17095,4.52129066384554
"3782",2006-01-16,4,3,-121.5118509,38.5586276,3782,17098,4.52088841882602
"3783",2006-01-16,6,3,-121.4443719,38.52783233,3783,17101,4.52048638646577
"3784",2006-01-16,3,7,-121.4035685,38.54941557,3784,17108,4.52114164904863
"3785",2006-01-16,2,5,-121.4500165,38.61868967,3785,17113,4.52126816380449
"3786",2006-01-16,3,5,-121.4809519,38.5790575,3786,17118,4.52139461172742
"3787",2006-01-16,5,1,-121.468665,38.48061188,3787,17119,4.52046474782149
"3788",2006-01-16,6,5,-121.4385109,38.53078064,3788,17124,4.52059134107709
"3789",2006-01-16,3,7,-121.4806992,38.57725503,3789,17131,4.52124571126946
"3790",2006-01-16,5,3,-121.4665775,38.4808851,3790,17134,4.52084432717678
"3791",2006-01-16,5,5,-121.4338336,38.45673254,3791,17139,4.52097072012662
"3792",2006-01-16,6,7,-121.4361765,38.54042404,3792,17146,4.52162447257384
"3793",2006-01-16,5,7,-121.4334256,38.47338747,3793,17153,4.52227788030583
"3794",2006-01-16,1,7,-121.4966948,38.62648616,3794,17160,4.52293094359515
"3795",2006-01-16,6,1,-121.44887,38.53789577,3795,17161,4.52200263504611
"3796",2006-01-16,4,8,-121.4741684,38.53452891,3796,17169,4.52291886195996
"3797",2006-01-16,6,5,-121.409083,38.51055016,3797,17174,4.52304450882276
"3798",2006-01-16,3,5,-121.4786515,38.56737967,3798,17179,4.5231700895208
"3799",2006-01-16,2,4,-121.4571721,38.63367782,3799,17183,4.5230323769413
"3800",2006-01-16,3,4,-121.4876931,38.56490201,3800,17187,4.52289473684211
"3801",2006-01-16,5,1,-121.4279242,38.46945288,3801,17188,4.52196790318337
"3802",2006-01-16,3,4,-121.4825709,38.56179004,3802,17192,4.52183061546554
"3803",2006-01-16,3,5,-121.5050785,38.59572389,3803,17197,4.5219563502498
"3804",2006-01-16,6,3,-121.4137192,38.52731583,3804,17200,4.52155625657203
"3805",2006-01-16,2,7,-121.445824,38.6122991,3805,17207,4.52220762155059
"3806",2006-01-16,1,5,-121.5106604,38.63839743,3806,17212,4.52233315817131
"3807",2006-01-17,3,4,-121.4726224,38.56822282,3807,17216,4.52219595482007
"3808",2006-01-17,1,5,-121.5005579,38.60969502,3808,17221,4.52232142857143
"3809",2006-01-17,4,1,-121.4908853,38.5488551,3809,17222,4.52139669204516
"3810",2006-01-17,4,6,-121.5010236,38.54965713,3810,17228,4.52178477690289
"3811",2006-01-17,3,4,-121.3974738,38.54899682,3811,17232,4.52164786145369
"3812",2006-01-17,4,4,-121.4923547,38.55218963,3812,17236,4.5215110178384
"3813",2006-01-17,1,5,-121.510595,38.61733037,3813,17241,4.52163650668765
"3814",2006-01-17,2,7,-121.4461937,38.61112011,3814,17248,4.52228631358154
"3815",2006-01-17,3,3,-121.4843219,38.57161734,3815,17251,4.5218872870249
"3816",2006-01-17,6,3,-121.4582582,38.54743009,3816,17254,4.52148846960168
"3817",2006-01-17,1,7,-121.546884,38.66402692,3817,17261,4.52213780455855
"3818",2006-01-17,1,5,-121.5288499,38.63499923,3818,17266,4.52226296490309
"3819",2006-01-17,4,1,-121.483171,38.5248104,3819,17267,4.52134066509557
"3820",2006-01-17,2,7,-121.4355093,38.59648756,3820,17274,4.52198952879581
"3821",2006-01-17,3,1,-121.4907988,38.57960099,3821,17275,4.5210677833028
"3822",2006-01-17,1,7,-121.5048798,38.65407136,3822,17282,4.52171637885924
"3823",2006-01-17,5,1,-121.4563746,38.48899029,3823,17283,4.5207951870259
"3824",2006-01-17,2,6,-121.3815598,38.63862878,3824,17289,4.5211820083682
"3825",2006-01-17,4,5,-121.4970403,38.52640925,3825,17294,4.52130718954248
"3826",2006-01-17,2,2,-121.4476543,38.61140992,3826,17296,4.52064819654992
"3827",2006-01-17,2,7,-121.454431,38.6405243,3827,17303,4.52129605435067
"3828",2006-01-17,4,2,-121.4752017,38.54139021,3828,17305,4.52063740856844
"3829",2006-01-17,6,7,-121.4306454,38.53078613,3829,17312,4.52128493079133
"3830",2006-01-17,6,4,-121.445432,38.53131653,3830,17316,4.52114882506527
"3831",2006-01-17,1,3,-121.4762363,38.63004757,3831,17319,4.52075176194205
"3832",2006-01-17,1,7,-121.5498201,38.66218212,3832,17326,4.5213987473904
"3833",2006-01-17,4,3,-121.4766447,38.55582667,3833,17329,4.52100182624576
"3834",2006-01-17,3,1,-121.4591287,38.57421261,3834,17330,4.52008346374544
"3835",2006-01-17,4,7,-121.484345,38.50502839,3835,17337,4.52073011734029
"3836",2006-01-17,2,1,-121.4461937,38.61112011,3836,17338,4.51981230448384
"3837",2006-01-17,3,5,-121.4886224,38.56601548,3837,17343,4.5199374511337
"3838",2006-01-17,5,5,-121.4684313,38.48151147,3838,17348,4.52006253256905
"3839",2006-01-17,5,7,-121.4955741,38.47765971,3839,17355,4.52070851784319
"3840",2006-01-17,5,5,-121.4998771,38.49371194,3840,17360,4.52083333333333
"3841",2006-01-17,2,7,-121.4306981,38.60964455,3841,17367,4.5214787815673
"3842",2006-01-17,3,1,-121.4674526,38.58045703,3842,17368,4.52056220718376
"3843",2006-01-17,5,4,-121.4742605,38.48927894,3843,17372,4.52042674993495
"3844",2006-01-17,1,6,-121.5330756,38.64726866,3844,17378,4.52081165452653
"3845",2006-01-17,6,4,-121.4466868,38.54892406,3845,17382,4.52067620286086
"3846",2006-01-17,2,1,-121.4237244,38.60950023,3846,17383,4.51976079043162
"3847",2006-01-17,2,1,-121.4203141,38.60324441,3847,17384,4.51884585391214
"3848",2006-01-17,3,5,-121.4834127,38.57884334,3848,17389,4.51897089397089
"3849",2006-01-17,4,7,-121.5478368,38.50339936,3849,17396,4.51961548454144
"3850",2006-01-17,1,7,-121.4749528,38.62988799,3850,17403,4.52025974025974
"3851",2006-01-17,4,7,-121.4795909,38.55463449,3851,17410,4.52090366138665
"3852",2006-01-17,1,7,-121.4971148,38.62698775,3852,17417,4.52154724818276
"3853",2006-01-17,5,1,-121.42717,38.47421612,3853,17418,4.52063327277446
"3854",2006-01-17,3,7,-121.4441463,38.57026986,3854,17425,4.52127659574468
"3855",2006-01-17,5,1,-121.4338127,38.4589237,3855,17426,4.52036316472114
"3856",2006-01-17,2,1,-121.4183691,38.62976876,3856,17427,4.51945020746888
"3857",2006-01-17,1,1,-121.5282186,38.62776114,3857,17428,4.51853772361939
"3858",2006-01-17,4,1,-121.4786198,38.50279498,3858,17429,4.51762571280456
"3859",2006-01-17,1,2,-121.5163987,38.62085306,3859,17431,4.51697330914745
"3860",2006-01-17,2,5,-121.4483735,38.63832633,3860,17436,4.51709844559586
"3861",2006-01-17,5,1,-121.455388,38.46442316,3861,17437,4.51618751618752
"3862",2006-01-17,3,6,-121.4692575,38.57201606,3862,17443,4.51657172449508
"3863",2006-01-17,5,7,-121.4303669,38.46360509,3863,17450,4.51721460005177
"3864",2006-01-17,4,1,-121.4908853,38.5488551,3864,17451,4.51630434782609
"3865",2006-01-17,2,7,-121.461357,38.65572801,3865,17458,4.51694695989651
"3866",2006-01-17,2,7,-121.461357,38.65572801,3866,17465,4.51758923952406
"3867",2006-01-17,4,1,-121.4891871,38.5496714,3867,17466,4.5166795965865
"3868",2006-01-17,5,5,-121.428883,38.44258851,3868,17471,4.51680455015512
"3869",2006-01-17,1,1,-121.4959999,38.63020663,3869,17472,4.5158955802533
"3870",2006-01-17,3,1,-121.4769586,38.57503046,3870,17473,4.51498708010336
"3871",2006-01-17,2,1,-121.4180257,38.63110431,3871,17474,4.51407904934126
"3872",2006-01-17,3,6,-121.4935219,38.57100991,3872,17480,4.51446280991736
"3873",2006-01-17,2,5,-121.4216656,38.61264781,3873,17485,4.5145881745417
"3874",2006-01-17,5,1,-121.428883,38.44258851,3874,17486,4.51368094992256
"3875",2006-01-17,6,1,-121.4461521,38.53266824,3875,17487,4.51277419354839
"3876",2006-01-17,4,7,-121.4932774,38.52960558,3876,17494,4.51341589267286
"3877",2006-01-17,3,1,-121.4100658,38.55783227,3877,17495,4.51250967242713
"3878",2006-01-17,6,3,-121.4680096,38.5526734,3878,17498,4.51211964930376
"3879",2006-01-17,4,5,-121.4992887,38.56068556,3879,17503,4.51224542407837
"3880",2006-01-17,4,5,-121.5423064,38.49556817,3880,17508,4.51237113402062
"3881",2006-01-17,1,7,-121.5079524,38.65031154,3881,17515,4.51301211028086
"3882",2006-01-17,3,1,-121.4100658,38.55783227,3882,17516,4.51210716125708
"3883",2006-01-17,6,3,-121.4009789,38.51050023,3883,17519,4.51171774401236
"3884",2006-01-17,5,7,-121.4384213,38.47774495,3884,17526,4.51235839340886
"3885",2006-01-17,1,5,-121.5086644,38.61458725,3885,17531,4.51248391248391
"3886",2006-01-17,6,1,-121.4318134,38.52545649,3886,17532,4.51158003088008
"3887",2006-01-17,2,5,-121.4623011,38.64013822,3887,17537,4.51170568561873
"3888",2006-01-17,5,5,-121.491628,38.4814126,3888,17542,4.51183127572016
"3889",2006-01-17,6,1,-121.4425904,38.52497346,3889,17543,4.51092825919259
"3890",2006-01-17,3,5,-121.4641608,38.57858559,3890,17548,4.51105398457584
"3891",2006-01-17,2,5,-121.4635168,38.63863084,3891,17553,4.51117964533539
"3892",2006-01-17,4,1,-121.4908853,38.5488551,3892,17554,4.51027749229188
"3893",2006-01-17,1,5,-121.4957497,38.66062772,3893,17559,4.51040328795274
"3894",2006-01-17,6,1,-121.4366852,38.51229152,3894,17560,4.50950179763739
"3895",2006-01-17,3,7,-121.4096655,38.54915301,3895,17567,4.51014120667522
"3896",2006-01-17,4,7,-121.4883563,38.50460411,3896,17574,4.51078028747433
"3897",2006-01-17,5,2,-121.4582942,38.48925192,3897,17576,4.51013600205286
"3898",2006-01-17,2,2,-121.4360584,38.62130809,3898,17578,4.50949204720369
"3899",2006-01-17,5,6,-121.4570142,38.47884153,3899,17584,4.50987432675045
"3900",2006-01-17,4,6,-121.4960208,38.55199422,3900,17590,4.51025641025641
"3901",2006-01-17,4,7,-121.514051,38.52212416,3901,17597,4.51089464239938
"3902",2006-01-17,1,5,-121.4939097,38.61545185,3902,17602,4.51101998974885
"3903",2006-01-17,3,7,-121.5011657,38.58184562,3903,17609,4.51165769920574
"3904",2006-01-17,6,3,-121.4448282,38.52983357,3904,17612,4.51127049180328
"3905",2006-01-17,3,7,-121.4982228,38.58097068,3905,17619,4.51190781049936
"3906",2006-01-17,5,8,-121.4859396,38.48934244,3906,17627,4.51280081925243
"3907",2006-01-17,3,3,-121.4966071,38.57991197,3907,17630,4.51241361658562
"3908",2006-01-17,3,3,-121.4887376,38.56311353,3908,17633,4.51202661207779
"3909",2006-01-17,3,2,-121.5027369,38.582786,3909,17635,4.51138398567409
"3910",2006-01-17,6,3,-121.4699432,38.53762902,3910,17638,4.51099744245524
"3911",2006-01-17,1,3,-121.5077758,38.67081464,3911,17641,4.51061109690616
"3912",2006-01-17,6,5,-121.4361683,38.50428456,3912,17646,4.51073619631902
"3913",2006-01-17,6,1,-121.4554708,38.55117621,3913,17647,4.50983899821109
"3914",2006-01-17,4,7,-121.5061404,38.56060791,3914,17654,4.51047521716914
"3915",2006-01-17,5,5,-121.4348784,38.47431447,3915,17659,4.51060025542784
"3916",2006-01-17,4,4,-121.5235712,38.50290927,3916,17663,4.51046986721144
"3917",2006-01-17,3,4,-121.482654,38.57829626,3917,17667,4.51033954557059
"3918",2006-01-17,5,8,-121.4859396,38.48934244,3918,17675,4.51123021949974
"3919",2006-01-17,1,1,-121.5059934,38.61618775,3919,17676,4.51033426894616
"3920",2006-01-17,4,5,-121.4909166,38.53172057,3920,17681,4.51045918367347
"3921",2006-01-17,1,4,-121.5055312,38.63589608,3921,17685,4.51032899770467
"3922",2006-01-17,5,9,-121.4673944,38.49407763,3922,17694,4.51147373788883
"3923",2006-01-17,4,3,-121.5061519,38.55996267,3923,17697,4.51108845271476
"3924",2006-01-17,5,7,-121.4232326,38.46003018,3924,17704,4.51172273190622
"3925",2006-01-17,2,5,-121.4164146,38.63248017,3925,17709,4.51184713375796
"3926",2006-01-17,6,6,-121.4254625,38.54146972,3926,17715,4.51222618441161
"3927",2006-01-17,2,6,-121.4432958,38.62234262,3927,17721,4.51260504201681
"3928",2006-01-17,5,4,-121.4784231,38.48714497,3928,17725,4.51247454175153
"3929",2006-01-17,3,4,-121.4637147,38.57325365,3929,17729,4.5123441079155
"3930",2006-01-17,2,6,-121.4201014,38.59025226,3930,17735,4.51272264631043
"3931",2006-01-17,4,4,-121.4937694,38.53514629,3931,17739,4.51259221572119
"3932",2006-01-17,3,3,-121.3921168,38.54654137,3932,17742,4.51220752797559
"3933",2006-01-17,3,4,-121.4749164,38.57493609,3933,17746,4.51207729468599
"3934",2006-01-17,1,7,-121.4725801,38.60802229,3934,17753,4.51270971021861
"3935",2006-01-17,4,2,-121.47576,38.54106323,3935,17755,4.51207115628971
"3936",2006-01-17,3,2,-121.4986248,38.58052209,3936,17757,4.51143292682927
"3937",2006-01-17,6,1,-121.4646263,38.52495123,3937,17758,4.51054102108204
"3938",2006-01-17,1,1,-121.5253761,38.63513882,3938,17759,4.50964956830879
"3939",2006-01-17,1,5,-121.4815734,38.62975579,3939,17764,4.50977405432851
"3940",2006-01-17,3,7,-121.4966071,38.57991197,3940,17771,4.51040609137056
"3941",2006-01-17,2,5,-121.4222039,38.62266496,3941,17776,4.51053032225323
"3942",2006-01-17,5,3,-121.4428191,38.46118894,3942,17779,4.5101471334348
"3943",2006-01-17,6,5,-121.4344635,38.53863631,3943,17784,4.51027136697946
"3944",2006-01-17,3,1,-121.4433291,38.57190252,3944,17785,4.50938133874239
"3945",2006-01-17,5,4,-121.4564494,38.4855939,3945,17789,4.50925221799747
"3946",2006-01-17,1,8,-121.4959999,38.63020663,3946,17797,4.51013684744045
"3947",2006-01-17,1,1,-121.4978994,38.62741952,3947,17798,4.50924752976945
"3948",2006-01-17,2,7,-121.4307335,38.62274838,3948,17805,4.50987841945289
"3949",2006-01-17,6,7,-121.4582532,38.5513046,3949,17812,4.51050898961762
"3950",2006-01-17,2,5,-121.447659,38.60764526,3950,17817,4.51063291139241
"3951",2006-01-17,3,1,-121.5053361,38.58278889,3951,17818,4.5097443685143
"3952",2006-01-17,5,1,-121.428879,38.45400615,3952,17819,4.50885627530364
"3953",2006-01-17,4,7,-121.5067204,38.55714501,3953,17826,4.50948646597521
"3954",2006-01-17,3,6,-121.4855296,38.5952625,3954,17832,4.50986342943854
"3955",2006-01-17,6,3,-121.4274484,38.51052171,3955,17835,4.5094816687737
"3956",2006-01-17,5,1,-121.4891013,38.48252455,3956,17836,4.50859453993933
"3957",2006-01-17,1,1,-121.5296877,38.63855311,3957,17837,4.50770785948951
"3958",2006-01-17,3,2,-121.4865771,38.59118394,3958,17839,4.50707427993936
"3959",2006-01-17,4,9,-121.4990149,38.52199137,3959,17848,4.50820914372316
"3960",2006-01-17,3,2,-121.3956435,38.54711178,3960,17850,4.50757575757576
"3961",2006-01-17,2,5,-121.4210363,38.61084607,3961,17855,4.50770007573845
"3962",2006-01-17,3,4,-121.4637147,38.57325365,3962,17859,4.50757193336699
"3963",2006-01-17,5,4,-121.4276816,38.45483499,3963,17863,4.5074438556649
"3964",2006-01-17,4,1,-121.4763166,38.54049185,3964,17864,4.50655903128153
"3965",2006-01-17,2,5,-121.4403913,38.63160443,3965,17869,4.50668348045397
"3966",2006-01-17,4,2,-121.4727965,38.52904451,3966,17871,4.50605143721634
"3967",2006-01-17,3,7,-121.5026883,38.59978862,3967,17878,4.50668011091505
"3968",2006-01-17,5,1,-121.4891094,38.48334563,3968,17879,4.50579637096774
"3969",2006-01-17,3,2,-121.4863575,38.58573502,3969,17881,4.50516502897455
"3970",2006-01-17,3,8,-121.4818932,38.5857673,3970,17889,4.50604534005038
"3971",2006-01-17,4,2,-121.4960651,38.53085892,3971,17891,4.50541425333669
"3972",2006-01-17,3,1,-121.5052755,38.58245363,3972,17892,4.50453172205438
"3973",2006-01-17,2,3,-121.4461973,38.60930232,3973,17895,4.50415303297256
"3974",2006-01-17,4,4,-121.5187268,38.51656122,3974,17899,4.50402617010569
"3975",2006-01-17,4,6,-121.5346969,38.50298477,3975,17905,4.50440251572327
"3976",2006-01-17,2,4,-121.4258271,38.6017616,3976,17909,4.50427565392354
"3977",2006-01-17,3,4,-121.4998526,38.56556204,3977,17913,4.50414885592155
"3978",2006-01-17,4,9,-121.4990149,38.52199137,3978,17922,4.5052790346908
"3979",2006-01-17,6,8,-121.4647075,38.54395353,3979,17930,4.5061573259613
"3980",2006-01-17,4,7,-121.4960208,38.55199422,3980,17937,4.50678391959799
"3981",2006-01-17,1,7,-121.4765366,38.63872883,3981,17944,4.5074101984426
"3982",2006-01-17,4,5,-121.5282515,38.51488974,3982,17949,4.50753390256153
"3983",2006-01-17,2,6,-121.4385612,38.63150496,3983,17955,4.5079086115993
"3984",2006-01-17,4,9,-121.4990149,38.52199137,3984,17964,4.50903614457831
"3985",2006-01-17,4,5,-121.5041133,38.52570388,3985,17969,4.50915934755333
"3986",2006-01-17,2,1,-121.4608874,38.63495006,3986,17970,4.50827897641746
"3987",2006-01-17,3,2,-121.4927485,38.56418287,3987,17972,4.50764986205167
"3988",2006-01-17,5,1,-121.4385398,38.46977953,3988,17973,4.5067703109328
"3989",2006-01-17,1,1,-121.4932977,38.61292566,3989,17974,4.50589120080221
"3990",2006-01-17,6,8,-121.415404,38.52732711,3990,17982,4.50676691729323
"3991",2006-01-17,2,4,-121.4506176,38.61335716,3991,17986,4.5066399398647
"3992",2006-01-17,5,1,-121.4385398,38.46977953,3992,17987,4.50576152304609
"3993",2006-01-17,2,1,-121.4549202,38.60815196,3993,17988,4.50488354620586
"3994",2006-01-17,6,6,-121.4685363,38.53735621,3994,17994,4.50525788683025
"3995",2006-01-17,5,5,-121.4267227,38.43811565,3995,17999,4.50538172715895
"3996",2006-01-17,2,4,-121.4295032,38.60240036,3996,18003,4.50525525525526
"3997",2006-01-17,4,9,-121.4990149,38.52199137,3997,18012,4.50637978483863
"3998",2006-01-17,2,5,-121.4297591,38.63647881,3998,18017,4.50650325162581
"3999",2006-01-17,4,7,-121.500048,38.54016571,3999,18024,4.50712678169542
"4000",2006-01-17,4,7,-121.5412748,38.5076709,4000,18031,4.50775
"4001",2006-01-17,1,4,-121.5119979,38.65731154,4001,18035,4.50762309422644
"4002",2006-01-17,1,5,-121.4978994,38.62741952,4002,18040,4.50774612693653
"4003",2006-01-17,4,9,-121.4990149,38.52199137,4003,18049,4.50886834873845
"4004",2006-01-17,6,7,-121.465067,38.53704366,4004,18056,4.50949050949051
"4005",2006-01-17,3,5,-121.4802031,38.58964798,4005,18061,4.50961298377029
"4006",2006-01-17,3,1,-121.4794029,38.57369871,4006,18062,4.50873689465801
"4007",2006-01-17,3,3,-121.4998385,38.57006806,4007,18065,4.50836036935363
"4008",2006-01-17,4,7,-121.500048,38.54016571,4008,18072,4.50898203592814
"4009",2006-01-17,1,5,-121.4936677,38.61257305,4009,18077,4.50910451484161
"4010",2006-01-17,3,5,-121.4630454,38.57944539,4010,18082,4.50922693266833
"4011",2006-01-17,4,7,-121.500048,38.54016571,4011,18089,4.50984791822488
"4012",2006-01-17,2,7,-121.42747,38.60154457,4012,18096,4.51046859421735
"4013",2006-01-17,2,1,-121.4473452,38.60930505,4013,18097,4.50959382008472
"4014",2006-01-17,3,3,-121.4658463,38.56838945,4014,18100,4.50921773791729
"4015",2006-01-17,4,5,-121.5145057,38.51590927,4015,18105,4.5093399750934
"4016",2006-01-17,4,5,-121.5227808,38.51921686,4016,18110,4.50946215139442
"4017",2006-01-17,3,4,-121.4028462,38.55048551,4017,18114,4.50933532486931
"4018",2006-01-17,6,6,-121.429358,38.51996349,4018,18120,4.50970632155301
"4019",2006-01-17,4,4,-121.4778223,38.53874125,4019,18124,4.50957949738741
"4020",2006-01-17,5,4,-121.4596858,38.49556587,4020,18128,4.50945273631841
"4021",2006-01-17,4,2,-121.4803518,38.49576768,4021,18130,4.50882864958965
"4022",2006-01-17,3,7,-121.4681696,38.56170554,4022,18137,4.50944803580308
"4023",2006-01-17,4,7,-121.500048,38.54016571,4023,18144,4.51006711409396
"4024",2006-01-17,4,1,-121.4768629,38.50603275,4024,18145,4.50919483101392
"4025",2006-01-17,6,6,-121.4658126,38.55093059,4025,18151,4.5095652173913
"4026",2006-01-17,6,5,-121.4116003,38.54307784,4026,18156,4.5096870342772
"4027",2006-01-17,4,2,-121.5058526,38.56277597,4027,18158,4.50906381922026
"4028",2006-01-17,5,4,-121.4556125,38.4840083,4028,18162,4.50893743793446
"4029",2006-01-17,4,3,-121.5068067,38.52137681,4029,18165,4.50856291883842
"4030",2006-01-17,2,3,-121.4586425,38.6341268,4030,18168,4.50818858560794
"4031",2006-01-17,4,7,-121.4918839,38.54120381,4031,18175,4.50880674770528
"4032",2006-01-17,6,7,-121.4557117,38.54021553,4032,18182,4.5094246031746
"4033",2006-01-17,5,6,-121.43393,38.47365629,4033,18188,4.50979419786759
"4034",2006-01-17,2,7,-121.4247793,38.64402751,4034,18195,4.51041150223104
"4035",2006-01-17,6,8,-121.4650574,38.5392541,4035,18203,4.51127633209418
"4036",2006-01-17,6,3,-121.428595,38.53231925,4036,18206,4.51090188305253
"4037",2006-01-17,1,5,-121.4779367,38.63160945,4037,18211,4.5110230369086
"4038",2006-01-17,2,7,-121.465939,38.61955775,4038,18218,4.51163942545815
"4039",2006-01-17,1,1,-121.5259712,38.64303305,4039,18219,4.51076999257242
"4040",2006-01-17,3,4,-121.4574953,38.57050893,4040,18223,4.51064356435644
"4041",2006-01-17,1,5,-121.4799334,38.6194402,4041,18228,4.51076466221232
"4042",2006-01-17,4,7,-121.5053339,38.55032643,4042,18235,4.51138050470064
"4043",2006-01-17,2,5,-121.4211625,38.61512488,4043,18240,4.51150136037596
"4044",2006-01-17,3,1,-121.4795335,38.57017351,4044,18241,4.51063303659743
"4045",2006-01-17,5,3,-121.4485769,38.48034756,4045,18244,4.51025957972806
"4046",2006-01-17,4,5,-121.4823115,38.52378506,4046,18249,4.51038062283737
"4047",2006-01-17,3,7,-121.4686143,38.58275798,4047,18256,4.51099579935755
"4048",2006-01-17,3,3,-121.4832986,38.57672297,4048,18259,4.51062252964427
"4049",2006-01-17,2,7,-121.4490916,38.61200165,4049,18266,4.51123734255372
"4050",2006-01-17,3,5,-121.4009248,38.54735343,4050,18271,4.51135802469136
"4051",2006-01-17,1,5,-121.5129202,38.63560611,4051,18276,4.51147864724759
"4052",2006-01-17,3,5,-121.4747617,38.56791951,4052,18281,4.51159921026654
"4053",2006-01-17,1,5,-121.5139237,38.61063608,4053,18286,4.51171971379225
"4054",2006-01-17,5,7,-121.4583887,38.48876908,4054,18293,4.51233349777997
"4055",2006-01-17,6,1,-121.4443436,38.52652786,4055,18294,4.511467324291
"4056",2006-01-17,6,6,-121.4728661,38.55513128,4056,18300,4.51183431952663
"4057",2006-01-17,6,7,-121.4254625,38.54146972,4057,18307,4.51244762139512
"4058",2006-01-17,3,3,-121.4858893,38.59049989,4058,18310,4.51207491375062
"4059",2006-01-17,2,5,-121.4397434,38.61693796,4059,18315,4.51219512195122
"4060",2006-01-17,1,4,-121.504924,38.62149931,4060,18319,4.51206896551724
"4061",2006-01-17,6,6,-121.470546,38.54120974,4061,18325,4.51243536074858
"4062",2006-01-17,1,4,-121.5283928,38.63476396,4062,18329,4.51230920728705
"4063",2006-01-17,1,4,-121.493964,38.61077027,4063,18333,4.51218311592419
"4064",2006-01-17,6,1,-121.4649158,38.55301886,4064,18334,4.5113188976378
"4065",2006-01-17,3,5,-121.4860977,38.57129023,4065,18339,4.51143911439114
"4066",2006-01-17,2,1,-121.4301956,38.62436035,4066,18340,4.51057550418101
"4067",2006-01-17,3,3,-121.4680876,38.56613712,4067,18343,4.51020408163265
"4068",2006-01-17,2,5,-121.4500914,38.63347967,4068,18348,4.51032448377581
"4069",2006-01-17,6,5,-121.4473321,38.52610557,4069,18353,4.51044482673876
"4070",2006-01-17,6,5,-121.4223013,38.52339385,4070,18358,4.51056511056511
"4071",2006-01-17,1,6,-121.4948736,38.60933262,4071,18364,4.51093097519037
"4072",2006-01-17,1,6,-121.4796664,38.61285973,4072,18370,4.51129666011788
"4073",2006-01-17,5,5,-121.4507883,38.46624668,4073,18375,4.51141664620673
"4074",2006-01-17,4,7,-121.5187359,38.48255011,4074,18382,4.51202749140893
"4075",2006-01-17,6,7,-121.4428888,38.55393092,4075,18389,4.51263803680982
"4076",2006-01-17,2,2,-121.4239904,38.59954474,4076,18391,4.51202158979392
"4077",2006-01-17,2,6,-121.4353699,38.63973826,4077,18397,4.51238655874417
"4078",2006-01-17,6,2,-121.3865679,38.51641638,4078,18399,4.51177047572339
"4079",2006-01-17,2,2,-121.4481855,38.62372526,4079,18401,4.51115469477813
"4080",2006-01-17,6,6,-121.4591542,38.54455104,4080,18407,4.51151960784314
"4081",2006-01-17,2,5,-121.4665975,38.61855028,4081,18412,4.51163930409213
"4082",2006-01-17,3,4,-121.4828749,38.59367176,4082,18416,4.51151396374326
"4083",2006-01-17,3,4,-121.4825709,38.56179004,4083,18420,4.5113886847906
"4084",2006-01-17,6,7,-121.4366482,38.51787111,4084,18427,4.51199804113614
"4085",2006-01-17,3,3,-121.3908868,38.54439581,4085,18430,4.51162790697674
"4086",2006-01-17,1,1,-121.4755257,38.63338067,4086,18431,4.51076847772883
"4087",2006-01-17,2,2,-121.4205488,38.62647906,4087,18433,4.5101541472963
"4088",2006-01-17,1,5,-121.4697938,38.61093125,4088,18438,4.51027397260274
"4089",2006-01-18,3,7,-121.4338815,38.56793823,4089,18445,4.51088285644412
"4090",2006-01-18,5,5,-121.4703136,38.49855045,4090,18450,4.51100244498778
"4091",2006-01-18,4,5,-121.5018623,38.51566329,4091,18455,4.51112197506722
"4092",2006-01-18,4,7,-121.5289716,38.51326708,4092,18462,4.51173020527859
"4093",2006-01-18,5,5,-121.4361716,38.44942327,4093,18467,4.51184949914488
"4094",2006-01-18,4,4,-121.4869479,38.55909654,4094,18471,4.51172447484123
"4095",2006-01-18,4,7,-121.4854019,38.53051542,4095,18478,4.51233211233211
"4096",2006-01-18,6,7,-121.4302218,38.51947073,4096,18485,4.512939453125
"4097",2006-01-18,6,1,-121.471825,38.53514705,4097,18486,4.51208201122773
"4098",2006-01-18,5,2,-121.455558,38.48795122,4098,18488,4.51146900927282
"4099",2006-01-18,2,3,-121.443841,38.62559095,4099,18491,4.51110026835814
"4100",2006-01-18,5,7,-121.4389102,38.44529571,4100,18498,4.51170731707317
"4101",2006-01-18,3,7,-121.4171174,38.56408209,4101,18505,4.51231406973909
"4102",2006-01-18,3,7,-121.4876022,38.57170879,4102,18512,4.5129205265724
"4103",2006-01-18,1,7,-121.518561,38.61371716,4103,18519,4.51352668778942
"4104",2006-01-18,1,6,-121.4792588,38.6092415,4104,18525,4.51388888888889
"4105",2006-01-18,5,3,-121.4561046,38.48728104,4105,18528,4.51352009744214
"4106",2006-01-18,6,7,-121.4211836,38.52846279,4106,18535,4.51412566975158
"4107",2006-01-18,6,3,-121.4367219,38.52358579,4107,18538,4.51375700024349
"4108",2006-01-18,6,7,-121.4351231,38.50565244,4108,18545,4.51436222005842
"4109",2006-01-18,4,4,-121.4992925,38.53124638,4109,18549,4.51423704064249
"4110",2006-01-18,1,1,-121.4798876,38.60892854,4110,18550,4.51338199513382
"4111",2006-01-18,5,7,-121.4189709,38.47433721,4111,18557,4.51398686450985
"4112",2006-01-18,6,5,-121.435864,38.5105054,4112,18562,4.51410505836576
"4113",2006-01-18,4,1,-121.4986029,38.52042714,4113,18563,4.51325066861172
"4114",2006-01-18,2,5,-121.4272941,38.64480059,4114,18568,4.51336898395722
"4115",2006-01-18,6,3,-121.4479715,38.53880039,4115,18571,4.51300121506683
"4116",2006-01-18,2,6,-121.4179054,38.62096842,4116,18577,4.51336248785228
"4117",2006-01-18,2,5,-121.422546,38.62234814,4117,18582,4.51348068982269
"4118",2006-01-18,5,7,-121.4452634,38.48328361,4118,18589,4.51408450704225
"4119",2006-01-18,2,5,-121.4267744,38.61798936,4119,18594,4.51420247632921
"4120",2006-01-18,1,1,-121.5395774,38.6272906,4120,18595,4.51334951456311
"4121",2006-01-18,1,4,-121.4984478,38.6270814,4121,18599,4.5132249454016
"4122",2006-01-18,1,2,-121.5055312,38.63589608,4122,18601,4.51261523532266
"4123",2006-01-18,6,7,-121.4184645,38.50736847,4123,18608,4.51321853019646
"4124",2006-01-18,3,6,-121.4075372,38.55152837,4124,18614,4.51357904946654
"4125",2006-01-18,6,6,-121.411208,38.52239057,4125,18620,4.51393939393939
"4126",2006-01-18,4,1,-121.476494,38.55683101,4126,18621,4.51308773630635
"4127",2006-01-18,2,3,-121.422546,38.62234814,4127,18624,4.51272110491883
"4128",2006-01-18,2,1,-121.4569219,38.64124446,4128,18625,4.51187015503876
"4129",2006-01-18,3,5,-121.4996207,38.58316799,4129,18630,4.51198837490918
"4130",2006-01-18,2,1,-121.437112,38.61819108,4130,18631,4.51113801452785
"4131",2006-01-18,3,2,-121.471865,38.58029601,4131,18633,4.51053013798112
"4132",2006-01-18,4,3,-121.4717471,38.52488785,4132,18636,4.51016456921588
"4133",2006-01-18,1,3,-121.5363135,38.65333642,4133,18639,4.50979917735301
"4134",2006-01-18,4,7,-121.5243785,38.51496724,4134,18646,4.5104015481374
"4135",2006-01-18,2,7,-121.4290403,38.61039427,4135,18653,4.51100362756953
"4136",2006-01-18,3,4,-121.3957274,38.54959457,4136,18657,4.51088007736944
"4137",2006-01-18,5,7,-121.430301,38.46005151,4137,18664,4.51148175006043
"4138",2006-01-18,4,7,-121.5414238,38.50133937,4138,18671,4.5120831319478
"4139",2006-01-18,4,4,-121.5403218,38.50912795,4139,18675,4.51195941048562
"4140",2006-01-18,4,4,-121.5061256,38.56022067,4140,18679,4.51183574879227
"4141",2006-01-18,1,5,-121.4839873,38.6116022,4141,18684,4.51195363438783
"4142",2006-01-18,2,5,-121.4630334,38.6242591,4142,18689,4.51207146306132
"4143",2006-01-18,3,3,-121.5067732,38.5712566,4143,18692,4.51170649287956
"4144",2006-01-18,3,7,-121.4907361,38.57907899,4144,18699,4.51230694980695
"4145",2006-01-18,5,7,-121.4401102,38.45123003,4145,18706,4.51290711700844
"4146",2006-01-18,2,1,-121.4427075,38.61564793,4146,18707,4.51205981669079
"4147",2006-01-18,4,1,-121.47576,38.54106323,4147,18708,4.51121292500603
"4148",2006-01-18,6,7,-121.4431889,38.52532233,4148,18715,4.51181292189007
"4149",2006-01-18,2,7,-121.4205256,38.61726903,4149,18722,4.51241262954929
"4150",2006-01-18,4,7,-121.515627,38.48714755,4150,18729,4.51301204819277
"4151",2006-01-18,2,7,-121.4552334,38.64639615,4151,18736,4.51361117802939
"4152",2006-01-18,3,6,-121.4907939,38.58029569,4152,18742,4.51396917148362
"4153",2006-01-18,4,7,-121.500048,38.54016571,4153,18749,4.51456778232603
"4154",2006-01-18,3,7,-121.5061463,38.57087225,4154,18756,4.51516610495908
"4155",2006-01-18,6,5,-121.4274484,38.51052171,4155,18761,4.51528279181709
"4156",2006-01-18,4,1,-121.4928237,38.54080977,4156,18762,4.51443695861405
"4157",2006-01-18,3,1,-121.4377221,38.56834962,4157,18763,4.51359153235506
"4158",2006-01-18,5,1,-121.498024,38.47599535,4158,18764,4.51274651274651
"4159",2006-01-18,2,5,-121.4239904,38.59954474,4159,18769,4.51286366915124
"4160",2006-01-18,4,7,-121.4791852,38.55895752,4160,18776,4.51346153846154
"4161",2006-01-18,4,7,-121.5558323,38.49605203,4161,18783,4.51405912040375
"4162",2006-01-18,5,7,-121.435773,38.45656628,4162,18790,4.51465641518501
"4163",2006-01-18,2,5,-121.4378691,38.62916206,4163,18795,4.51477300024021
"4164",2006-01-18,6,7,-121.4428126,38.51083839,4164,18802,4.51536983669549
"4165",2006-01-18,2,1,-121.4545664,38.65851633,4165,18803,4.51452581032413
"4166",2006-01-18,2,1,-121.4508063,38.60931053,4166,18804,4.51368218915026
"4167",2006-01-18,6,6,-121.4254625,38.54146972,4167,18810,4.51403887688985
"4168",2006-01-18,2,1,-121.4301867,38.63466859,4168,18811,4.51319577735125
"4169",2006-01-18,2,3,-121.433145,38.62541828,4169,18814,4.51283281362437
"4170",2006-01-18,2,5,-121.4409276,38.65473334,4170,18819,4.51294964028777
"4171",2006-01-18,3,7,-121.4847979,38.58078266,4171,18826,4.51354591225126
"4172",2006-01-18,2,5,-121.4280294,38.62821323,4172,18831,4.51366251198466
"4173",2006-01-18,4,1,-121.4946908,38.55067586,4173,18832,4.51282051282051
"4174",2006-01-18,2,1,-121.433145,38.62541828,4174,18833,4.51197891710589
"4175",2006-01-18,6,6,-121.4254625,38.54146972,4175,18839,4.51233532934132
"4176",2006-01-18,5,4,-121.4859396,38.48934244,4176,18843,4.51221264367816
"4177",2006-01-18,6,7,-121.4005808,38.53752113,4177,18850,4.51280823557577
"4178",2006-01-18,1,5,-121.4966965,38.62078836,4178,18855,4.51292484442317
"4179",2006-01-18,6,5,-121.3867994,38.52120656,4179,18860,4.51304139746351
"4180",2006-01-18,2,1,-121.4305962,38.63292418,4180,18861,4.5122009569378
"4181",2006-01-18,4,9,-121.4990149,38.52199137,4181,18870,4.51327433628319
"4182",2006-01-18,2,6,-121.3815598,38.63862878,4182,18876,4.51362984218077
"4183",2006-01-18,6,7,-121.4337511,38.50591483,4183,18883,4.51422424097538
"4184",2006-01-18,3,7,-121.4707544,38.56684956,4184,18890,4.51481835564054
"4185",2006-01-18,5,1,-121.4866458,38.4756653,4185,18891,4.51397849462366
"4186",2006-01-18,1,6,-121.5048798,38.65407136,4186,18897,4.51433349259436
"4187",2006-01-18,2,1,-121.4427075,38.61564793,4187,18898,4.51349414855505
"4188",2006-01-18,3,1,-121.5014996,38.58062786,4188,18899,4.51265520534862
"4189",2006-01-18,6,5,-121.3867994,38.52120656,4189,18904,4.51277154452137
"4190",2006-01-18,1,5,-121.4755308,38.62697168,4190,18909,4.51288782816229
"4191",2006-01-18,2,1,-121.4365799,38.62130239,4191,18910,4.51204963015987
"4192",2006-01-18,6,5,-121.4586686,38.5440243,4192,18915,4.51216603053435
"4193",2006-01-18,6,4,-121.4675138,38.52492611,4193,18919,4.51204388266158
"4194",2006-01-18,1,7,-121.5350231,38.64877851,4194,18926,4.51263710061993
"4195",2006-01-18,4,6,-121.4960208,38.55199422,4195,18932,4.51299165673421
"4196",2006-01-18,4,7,-121.5223627,38.48715361,4196,18939,4.51358436606292
"4197",2006-01-18,6,4,-121.4460999,38.55651105,4197,18943,4.51346199666428
"4198",2006-01-18,2,1,-121.433145,38.62541828,4198,18944,4.51262505955217
"4199",2006-01-18,3,2,-121.4984909,38.57966477,4199,18946,4.51202667301739
"4200",2006-01-18,2,4,-121.4386646,38.60459245,4200,18950,4.51190476190476
"4201",2006-01-18,2,6,-121.3815598,38.63862878,4201,18956,4.51225898595573
"4202",2006-01-18,4,4,-121.5071286,38.49297696,4202,18960,4.5121370775821
"4203",2006-01-18,2,1,-121.4317459,38.62879718,4203,18961,4.51130145134428
"4204",2006-01-18,3,8,-121.3956411,38.54697447,4204,18969,4.51213130352046
"4205",2006-01-18,6,2,-121.4652265,38.55169126,4205,18971,4.5115338882283
"4206",2006-01-18,2,1,-121.4340925,38.62379457,4206,18972,4.51069900142653
"4207",2006-01-18,2,1,-121.4427075,38.61564793,4207,18973,4.5098645115284
"4208",2006-01-18,6,5,-121.3895927,38.52196274,4208,18978,4.50998098859316
"4209",2006-01-18,1,5,-121.4767711,38.62824591,4209,18983,4.51009741031124
"4210",2006-01-18,3,7,-121.4143835,38.57204528,4210,18990,4.51068883610451
"4211",2006-01-18,5,7,-121.4412886,38.46620664,4211,18997,4.51127998100214
"4212",2006-01-18,1,2,-121.5161468,38.65847399,4212,18999,4.51068376068376
"4213",2006-01-18,4,6,-121.4908853,38.5488551,4213,19005,4.51103726560646
"4214",2006-01-18,3,5,-121.4891184,38.57197086,4214,19010,4.51115329852871
"4215",2006-01-18,6,1,-121.460415,38.54704475,4215,19011,4.51032028469751
"4216",2006-01-18,1,3,-121.5079398,38.64199956,4216,19014,4.50996204933586
"4217",2006-01-18,2,1,-121.450146,38.61051836,4217,19015,4.50912971306616
"4218",2006-01-18,4,1,-121.4986029,38.52042714,4218,19016,4.50829777145567
"4219",2006-01-18,2,1,-121.4291487,38.64493057,4219,19017,4.50746622422375
"4220",2006-01-18,2,1,-121.4377392,38.61900143,4220,19018,4.50663507109005
"4221",2006-01-18,6,5,-121.4287388,38.5139111,4221,19023,4.50675195451315
"4222",2006-01-18,2,4,-121.4573143,38.6265006,4222,19027,4.50663192799621
"4223",2006-01-18,1,4,-121.5120524,38.65599922,4223,19031,4.50651195832347
"4224",2006-01-18,2,1,-121.4438554,38.61655961,4224,19032,4.50568181818182
"4225",2006-01-18,4,4,-121.5212433,38.49466185,4225,19036,4.50556213017751
"4226",2006-01-18,4,1,-121.5373669,38.47866928,4226,19037,4.50473260766682
"4227",2006-01-18,6,4,-121.4131567,38.53365613,4227,19041,4.50461320085167
"4228",2006-01-18,1,4,-121.5152564,38.65603463,4228,19045,4.50449385052034
"4229",2006-01-18,3,3,-121.4879497,38.58615671,4229,19048,4.50413809411208
"4230",2006-01-18,4,3,-121.4955208,38.54208195,4230,19051,4.50378250591017
"4231",2006-01-18,4,7,-121.4990149,38.52199137,4231,19058,4.50437248877334
"4232",2006-01-18,5,8,-121.4276816,38.45483499,4232,19066,4.50519848771267
"4233",2006-01-18,2,5,-121.450115,38.60909032,4233,19071,4.50531537916371
"4234",2006-01-18,3,1,-121.5052755,38.58245363,4234,19072,4.50448748228625
"4235",2006-01-18,3,8,-121.4946947,38.57975261,4235,19080,4.50531286894923
"4236",2006-01-18,3,5,-121.4891338,38.56493858,4236,19085,4.50542965061379
"4237",2006-01-18,2,7,-121.4323978,38.63045618,4237,19092,4.50601840925183
"4238",2006-01-18,5,1,-121.4409821,38.4643132,4238,19093,4.50519112789051
"4239",2006-01-18,2,1,-121.450227,38.61181758,4239,19094,4.50436423684831
"4240",2006-01-18,5,1,-121.4409821,38.4643132,4240,19095,4.50353773584906
"4241",2006-01-18,1,2,-121.4983584,38.67958595,4241,19097,4.50294741806178
"4242",2006-01-18,3,5,-121.4329117,38.5671756,4242,19102,4.5030645921735
"4243",2006-01-18,5,5,-121.4898347,38.4898924,4243,19107,4.5031817110535
"4244",2006-01-18,2,7,-121.4529334,38.62945934,4244,19114,4.50377002827521
"4245",2006-01-18,2,1,-121.4415705,38.61111988,4245,19115,4.50294464075383
"4246",2006-01-18,3,1,-121.4329117,38.5671756,4246,19116,4.50211964201601
"4247",2006-01-18,4,1,-121.47652,38.55614464,4247,19117,4.50129503178714
"4248",2006-01-18,1,6,-121.5132857,38.62309993,4248,19123,4.50164783427495
"4249",2006-01-18,3,2,-121.496949,38.59839361,4249,19125,4.50105907272299
"4250",2006-01-18,5,7,-121.4223876,38.47038918,4250,19132,4.50164705882353
"4251",2006-01-18,4,3,-121.5060656,38.49563049,4251,19135,4.50129381322042
"4252",2006-01-18,3,2,-121.4864165,38.59308341,4252,19137,4.50070555032926
"4253",2006-01-18,5,8,-121.4465943,38.47427504,4253,19145,4.50152833294145
"4254",2006-01-18,3,1,-121.4878161,38.5857662,4254,19146,4.50070521861777
"4255",2006-01-18,4,5,-121.5403218,38.50912795,4255,19151,4.50082256169213
"4256",2006-01-18,2,7,-121.4263723,38.63273584,4256,19158,4.50140977443609
"4257",2006-01-18,1,4,-121.5000769,38.61890556,4257,19162,4.50129198966408
"4258",2006-01-18,2,4,-121.4562854,38.64436086,4258,19166,4.50117426021606
"4259",2006-01-18,3,5,-121.4774851,38.59340867,4259,19171,4.50129138295375
"4260",2006-01-18,4,3,-121.5250302,38.5126194,4260,19174,4.50093896713615
"4261",2006-01-18,4,3,-121.5231426,38.49540836,4261,19177,4.50058671673316
"4262",2006-01-18,2,1,-121.4573227,38.6111316,4262,19178,4.49976536837166
"4263",2006-01-18,5,5,-121.4191049,38.46817048,4263,19183,4.49988271170537
"4264",2006-01-18,5,2,-121.4992251,38.47756849,4264,19185,4.49929643527205
"4265",2006-01-18,3,5,-121.4807337,38.56097725,4265,19190,4.49941383352872
"4266",2006-01-18,3,3,-121.455382,38.56235453,4266,19193,4.49906235349273
"4267",2006-01-18,2,4,-121.4258271,38.6017616,4267,19197,4.49894539489102
"4268",2006-01-18,3,7,-121.4986248,38.58052209,4268,19204,4.49953139643861
"4269",2006-01-18,2,1,-121.4415705,38.61111988,4269,19205,4.49871164207074
"4270",2006-01-18,4,5,-121.4768518,38.55524272,4270,19210,4.49882903981265
"4271",2006-01-18,6,7,-121.4393168,38.52698964,4271,19217,4.499414656989
"4272",2006-01-18,4,1,-121.4743108,38.53513366,4272,19218,4.49859550561798
"4273",2006-01-18,5,6,-121.4418427,38.47531213,4273,19224,4.49894687573134
"4274",2006-01-18,4,6,-121.4794001,38.53428621,4274,19230,4.49929808142256
"4275",2006-01-18,6,6,-121.4549589,38.54220005,4275,19236,4.49964912280702
"4276",2006-01-18,3,3,-121.4854695,38.56623766,4276,19239,4.49929840972872
"4277",2006-01-18,5,6,-121.4560039,38.48812631,4277,19245,4.49964928688333
"4278",2006-01-18,4,4,-121.4977227,38.5332551,4278,19249,4.49953249181861
"4279",2006-01-18,5,6,-121.4730323,38.49521557,4279,19255,4.49988315026875
"4280",2006-01-18,5,2,-121.4564025,38.48807602,4280,19257,4.49929906542056
"4281",2006-01-18,6,2,-121.4526562,38.54611863,4281,19259,4.49871525344546
"4282",2006-01-18,2,1,-121.4392432,38.61111688,4282,19260,4.4978981784213
"4283",2006-01-18,4,7,-121.4842454,38.49608441,4283,19267,4.49848237216904
"4284",2006-01-18,2,2,-121.4461582,38.62198839,4284,19269,4.49789915966387
"4285",2006-01-18,6,6,-121.4603332,38.54584439,4285,19275,4.49824970828471
"4286",2006-01-18,5,7,-121.4219209,38.44733459,4286,19282,4.49883341110593
"4287",2006-01-18,2,1,-121.3652379,38.64370841,4287,19283,4.49801726148822
"4288",2006-01-18,2,5,-121.4438768,38.61112,4288,19288,4.49813432835821
"4289",2006-01-18,3,3,-121.4813882,38.59266833,4289,19291,4.49778503147587
"4290",2006-01-18,2,1,-121.4213003,38.61108354,4290,19292,4.4969696969697
"4291",2006-01-18,3,4,-121.4976906,38.57905171,4291,19296,4.4968538802144
"4292",2006-01-18,5,6,-121.4359472,38.47431969,4292,19302,4.49720410065238
"4293",2006-01-18,3,4,-121.4751606,38.57455002,4293,19306,4.4970882832518
"4294",2006-01-18,3,3,-121.4868341,38.58464151,4294,19309,4.49673963670238
"4295",2006-01-18,6,5,-121.4598209,38.54561958,4295,19314,4.49685681024447
"4296",2006-01-18,5,5,-121.4271832,38.46734582,4296,19319,4.4969739292365
"4297",2006-01-18,4,2,-121.5389783,38.5077414,4297,19321,4.49639283220852
"4298",2006-01-18,1,5,-121.4808039,38.63111708,4298,19326,4.49651000465333
"4299",2006-01-18,4,7,-121.513646,38.53385584,4299,19333,4.49709234705746
"4300",2006-01-18,2,1,-121.4487064,38.61112661,4300,19334,4.49627906976744
"4301",2006-01-18,2,3,-121.4503749,38.61986389,4301,19337,4.49593117879563
"4302",2006-01-18,6,1,-121.4714437,38.55500397,4302,19338,4.49511854951186
"4303",2006-01-18,5,4,-121.4170895,38.46689445,4303,19342,4.49500348594004
"4304",2006-01-18,5,4,-121.4312015,38.47591105,4304,19346,4.49488847583643
"4305",2006-01-18,2,2,-121.4548423,38.6078111,4305,19348,4.49430894308943
"4306",2006-01-18,4,1,-121.4734331,38.53515164,4306,19349,4.49349744542499
"4307",2006-01-18,3,3,-121.5011657,38.58184562,4307,19352,4.49315068493151
"4308",2006-01-18,4,6,-121.5061825,38.56209913,4308,19358,4.49350046425255
"4309",2006-01-18,1,1,-121.5045655,38.62927151,4309,19359,4.49268971919239
"4310",2006-01-18,4,7,-121.4957727,38.56285332,4310,19366,4.49327146171694
"4311",2006-01-18,6,7,-121.4308901,38.51894131,4311,19373,4.49385293435398
"4312",2006-01-18,3,5,-121.3843867,38.54927393,4312,19378,4.49397031539889
"4313",2006-01-18,3,7,-121.4069663,38.55542745,4313,19385,4.49455135636448
"4314",2006-01-18,3,7,-121.4919796,38.57344155,4314,19392,4.49513212795549
"4315",2006-01-18,2,1,-121.4484965,38.6102167,4315,19393,4.49432213209734
"4316",2006-01-18,5,7,-121.4787435,38.48250578,4316,19400,4.49490268767377
"4317",2006-01-18,6,5,-121.4715398,38.55477924,4317,19405,4.49501968959926
"4318",2006-01-18,5,7,-121.4758037,38.48227007,4318,19412,4.49559981472904
"4319",2006-01-18,2,4,-121.4490916,38.61200165,4319,19416,4.4954850659875
"4320",2006-01-18,6,5,-121.3744648,38.51835337,4320,19421,4.49560185185185
"4321",2006-01-18,2,5,-121.4615346,38.61507796,4321,19426,4.49571858366119
"4322",2006-01-18,1,7,-121.5099854,38.62607633,4322,19433,4.49629801018047
"4323",2006-01-18,3,7,-121.451116,38.58089148,4323,19440,4.49687716863289
"4324",2006-01-18,3,1,-121.4974099,38.58314743,4324,19441,4.49606845513414
"4325",2006-01-18,4,6,-121.479014,38.53881527,4325,19447,4.4964161849711
"4326",2006-01-18,4,6,-121.4813264,38.54005859,4326,19453,4.49676375404531
"4327",2006-01-18,4,4,-121.5042454,38.51473168,4327,19457,4.49664894846314
"4328",2006-01-18,3,5,-121.4915172,38.57795109,4328,19462,4.49676524953789
"4329",2006-01-18,6,5,-121.4566752,38.54454492,4329,19467,4.4968814968815
"4330",2006-01-18,3,7,-121.4780844,38.56027062,4330,19474,4.49745958429561
"4331",2006-01-18,6,7,-121.4620963,38.5448064,4331,19481,4.49803740475641
"4332",2006-01-18,3,2,-121.4884229,38.58506592,4332,19483,4.49746075715605
"4333",2006-01-18,2,3,-121.4489382,38.62053806,4333,19486,4.49711516270482
"4334",2006-01-18,4,2,-121.4866729,38.56037767,4334,19488,4.49653899400092
"4335",2006-01-18,1,4,-121.4960446,38.62586276,4335,19492,4.49642445213379
"4336",2006-01-18,4,8,-121.4953461,38.53218208,4336,19500,4.49723247232472
"4337",2006-01-18,3,7,-121.4969844,38.58246459,4337,19507,4.49780954576896
"4338",2006-01-18,2,7,-121.4275537,38.59808509,4338,19514,4.49838635315814
"4339",2006-01-18,4,2,-121.4963791,38.56266375,4339,19516,4.49781055542752
"4340",2006-01-18,2,7,-121.4349437,38.62592409,4340,19523,4.49838709677419
"4341",2006-01-18,6,5,-121.3875267,38.52442868,4341,19528,4.49850264915918
"4342",2006-01-18,5,1,-121.42717,38.47421612,4342,19529,4.49769691386458
"4343",2006-01-18,2,1,-121.419733,38.63596222,4343,19530,4.49689154962008
"4344",2006-01-18,5,5,-121.4772144,38.4885729,4344,19535,4.4970073664825
"4345",2006-01-18,3,4,-121.4037764,38.55048482,4345,19539,4.49689298043728
"4346",2006-01-18,1,4,-121.4755923,38.60672341,4346,19543,4.49677864703175
"4347",2006-01-18,5,1,-121.4847037,38.49502927,4347,19544,4.49597423510467
"4348",2006-01-18,2,3,-121.4514476,38.61647499,4348,19547,4.49563017479301
"4349",2006-01-18,4,6,-121.479014,38.53881527,4349,19553,4.49597608645666
"4350",2006-01-18,2,5,-121.4657312,38.60337222,4350,19558,4.49609195402299
"4351",2006-01-18,6,6,-121.4608546,38.54624499,4351,19564,4.4964376005516
"4352",2006-01-18,1,5,-121.5129034,38.64420903,4352,19569,4.49655330882353
"4353",2006-01-18,2,5,-121.4287837,38.6397966,4353,19574,4.49666896393292
"4354",2006-01-18,6,6,-121.4608546,38.54624499,4354,19580,4.49701423977951
"4355",2006-01-18,6,3,-121.4554904,38.53944288,4355,19583,4.49667049368542
"4356",2006-01-18,5,1,-121.4503108,38.47429277,4356,19584,4.49586776859504
"4357",2006-01-18,5,7,-121.4196575,38.47581524,4357,19591,4.49644250631168
"4358",2006-01-18,6,1,-121.4435986,38.52433302,4358,19592,4.49564020192749
"4359",2006-01-18,2,3,-121.4487064,38.61112661,4359,19595,4.49529708648773
"4360",2006-01-18,6,1,-121.4435986,38.52433302,4360,19596,4.49449541284404
"4361",2006-01-18,3,7,-121.4648897,38.57188611,4361,19603,4.49506993808759
"4362",2006-01-18,5,2,-121.4499836,38.48003574,4362,19605,4.49449793672627
"4363",2006-01-18,5,5,-121.4280259,38.46940671,4363,19610,4.49461379784552
"4364",2006-01-18,3,7,-121.4692557,38.57837291,4364,19617,4.49518790100825
"4365",2006-01-18,3,5,-121.3833572,38.55915665,4365,19622,4.49530355097365
"4366",2006-01-18,1,5,-121.5090345,38.62844479,4366,19627,4.49541914796152
"4367",2006-01-18,4,7,-121.4907674,38.50854144,4367,19634,4.49599267231509
"4368",2006-01-18,1,5,-121.4998065,38.61353883,4368,19639,4.49610805860806
"4369",2006-01-18,5,7,-121.4191177,38.45886451,4369,19646,4.49668116273747
"4370",2006-01-18,1,7,-121.5058946,38.62843144,4370,19653,4.49725400457666
"4371",2006-01-18,2,1,-121.4499687,38.60673086,4371,19654,4.49645390070922
"4372",2006-01-18,1,5,-121.4823437,38.62203217,4372,19659,4.49656907593779
"4373",2006-01-18,5,6,-121.4261773,38.44734482,4373,19665,4.49691287445689
"4374",2006-01-18,3,5,-121.4785389,38.56842536,4374,19670,4.49702789208962
"4375",2006-01-18,3,7,-121.4745807,38.57967955,4375,19677,4.4976
"4376",2006-01-18,3,3,-121.4976906,38.57905171,4376,19680,4.49725776965265
"4377",2006-01-18,6,5,-121.4095726,38.51007761,4377,19685,4.49737262965501
"4378",2006-01-18,6,4,-121.4115487,38.53788497,4378,19689,4.49725902238465
"4379",2006-01-18,5,7,-121.4578369,38.47263407,4379,19696,4.49783055492122
"4380",2006-01-18,2,4,-121.4329623,38.60086039,4380,19700,4.49771689497717
"4381",2006-01-18,2,2,-121.4523173,38.61670153,4381,19702,4.4971467701438
"4382",2006-01-18,6,1,-121.4401502,38.51966749,4382,19703,4.4963486992241
"4383",2006-01-18,6,7,-121.4660167,38.54469,4383,19710,4.49691991786448
"4384",2006-01-19,3,6,-121.4840835,38.57750632,4384,19716,4.49726277372263
"4385",2006-01-19,1,7,-121.4729293,38.60717264,4385,19723,4.49783352337514
"4386",2006-01-19,2,7,-121.4585103,38.60683427,4386,19730,4.4984040127679
"4387",2006-01-19,4,8,-121.4852041,38.52207627,4387,19738,4.49920218828357
"4388",2006-01-19,3,5,-121.4707875,38.57983801,4388,19743,4.49931631722881
"4389",2006-01-19,2,5,-121.4313881,38.61264377,4389,19748,4.49943039416724
"4390",2006-01-19,3,7,-121.4167663,38.56210598,4390,19755,4.5
"4391",2006-01-19,4,7,-121.5280659,38.48744887,4391,19762,4.50056934639034
"4392",2006-01-19,5,4,-121.4266738,38.47380451,4392,19766,4.50045537340619
"4393",2006-01-19,3,7,-121.4764173,38.57871855,4393,19773,4.50102435693148
"4394",2006-01-19,6,7,-121.4431889,38.52532233,4394,19780,4.50159308147474
"4395",2006-01-19,6,3,-121.4662161,38.54140403,4395,19783,4.50125142207053
"4396",2006-01-19,6,8,-121.4157726,38.50151426,4396,19791,4.50204731574158
"4397",2006-01-19,5,3,-121.4465943,38.47427504,4397,19794,4.50170570843757
"4398",2006-01-19,5,3,-121.4465943,38.47427504,4398,19797,4.50136425648022
"4399",2006-01-19,5,7,-121.4279114,38.46800845,4399,19804,4.50193225733121
"4400",2006-01-19,3,8,-121.482551,38.57948479,4400,19812,4.50272727272727
"4401",2006-01-19,4,3,-121.4909166,38.53172057,4401,19815,4.50238582140423
"4402",2006-01-19,1,1,-121.500334,38.63365507,4402,19816,4.50159018627896
"4403",2006-01-19,2,6,-121.4546338,38.61676738,4403,19822,4.5019305019305
"4404",2006-01-19,3,2,-121.3826394,38.56411202,4404,19824,4.50136239782016
"4405",2006-01-19,3,1,-121.4907988,38.57960099,4405,19825,4.5005675368899
"4406",2006-01-19,1,7,-121.5372839,38.646805,4406,19832,4.50113481615978
"4407",2006-01-19,2,5,-121.4297325,38.64768488,4407,19837,4.50124801452235
"4408",2006-01-19,3,5,-121.4648897,38.57188611,4408,19842,4.5013611615245
"4409",2006-01-19,3,4,-121.4976906,38.57905171,4409,19846,4.501247448401
"4410",2006-01-19,5,5,-121.4279242,38.46945288,4410,19851,4.50136054421769
"4411",2006-01-19,2,7,-121.4675522,38.64725247,4411,19858,4.50192700068012
"4412",2006-01-19,6,1,-121.4538401,38.54675579,4412,19859,4.50113327289211
"4413",2006-01-19,3,7,-121.4106008,38.56715202,4413,19866,4.50169952413324
"4414",2006-01-19,6,6,-121.4190149,38.51144623,4414,19872,4.50203896692343
"4415",2006-01-19,4,3,-121.5155752,38.49118111,4415,19875,4.50169875424689
"4416",2006-01-19,2,7,-121.4522298,38.6157977,4416,19882,4.50226449275362
"4417",2006-01-19,2,7,-121.4621619,38.62518044,4417,19889,4.50282997509622
"4418",2006-01-19,4,5,-121.4771739,38.53227712,4418,19894,4.50294250792214
"4419",2006-01-19,6,2,-121.417646,38.5096023,4419,19896,4.50237610319077
"4420",2006-01-19,4,1,-121.4737305,38.53275029,4420,19897,4.50158371040724
"4421",2006-01-19,1,4,-121.5325738,38.63729892,4421,19901,4.50147025559828
"4422",2006-01-19,1,7,-121.4787269,38.6121196,4422,19908,4.50203527815468
"4423",2006-01-19,4,6,-121.4879622,38.5074142,4423,19914,4.50237395432964
"4424",2006-01-19,6,5,-121.3837627,38.52921412,4424,19919,4.50248643761302
"4425",2006-01-19,6,1,-121.440543,38.546706,4425,19920,4.50169491525424
"4426",2006-01-19,3,5,-121.4862108,38.56724322,4426,19925,4.50180750112969
"4427",2006-01-19,3,1,-121.5014414,38.58243993,4427,19926,4.50101648972216
"4428",2006-01-19,3,5,-121.5085063,38.56897661,4428,19931,4.50112917795845
"4429",2006-01-19,1,7,-121.4985029,38.6237316,4429,19938,4.50169338451118
"4430",2006-01-19,2,6,-121.4596545,38.65950124,4430,19944,4.5020316027088
"4431",2006-01-19,1,1,-121.5062008,38.63879589,4431,19945,4.50124125479576
"4432",2006-01-19,2,6,-121.4459228,38.61264831,4432,19951,4.50157942238267
"4433",2006-01-19,2,5,-121.4568936,38.64404243,4433,19956,4.50169185653057
"4434",2006-01-19,4,7,-121.5054505,38.56629455,4434,19963,4.50225529995489
"4435",2006-01-19,3,7,-121.473383,38.57179875,4435,19970,4.50281848928974
"4436",2006-01-19,3,1,-121.4844897,38.59390962,4436,19971,4.50202885482417
"4437",2006-01-19,3,1,-121.4956541,38.58211006,4437,19972,4.50123957629029
"4438",2006-01-19,3,1,-121.4844897,38.59390962,4438,19973,4.5004506534475
"4439",2006-01-19,4,2,-121.4990149,38.52199137,4439,19975,4.49988736201847
"4440",2006-01-19,5,5,-121.4651562,38.48361349,4440,19980,4.5
"4441",2006-01-19,3,3,-121.5008344,38.58370044,4441,19983,4.49966223823463
"4442",2006-01-19,6,8,-121.4203096,38.51598904,4442,19991,4.5004502476362
"4443",2006-01-19,1,5,-121.511255,38.61959855,4443,19996,4.50056268287193
"4444",2006-01-19,3,5,-121.4816396,38.57010333,4444,20001,4.50067506750675
"4445",2006-01-19,2,8,-121.4427075,38.61564793,4445,20009,4.50146231721035
"4446",2006-01-19,5,6,-121.4641983,38.48697009,4446,20015,4.50179937022042
"4447",2006-01-19,3,1,-121.4844897,38.59390962,4447,20016,4.50101191814707
"4448",2006-01-19,1,3,-121.5043527,38.62464096,4448,20019,4.50067446043165
"4449",2006-01-19,6,3,-121.459536,38.54584067,4449,20022,4.50033715441672
"4450",2006-01-19,1,5,-121.5047875,38.62352523,4450,20027,4.50044943820225
"4451",2006-01-19,5,7,-121.4569973,38.46728652,4451,20034,4.50101100876208
"4452",2006-01-19,3,3,-121.4995651,38.56965224,4452,20037,4.50067385444744
"4453",2006-01-19,2,1,-121.4487064,38.61112661,4453,20038,4.49988771614642
"4454",2006-01-19,1,2,-121.5093115,38.67160923,4454,20040,4.49932644813651
"4455",2006-01-19,6,1,-121.4693358,38.55302823,4455,20041,4.49854096520763
"4456",2006-01-19,4,2,-121.4757806,38.55443881,4456,20043,4.4979802513465
"4457",2006-01-19,2,7,-121.4300114,38.6377679,4457,20050,4.49854161992372
"4458",2006-01-19,3,1,-121.4944195,38.57810659,4458,20051,4.49775684163302
"4459",2006-01-19,4,1,-121.4776517,38.55441706,4459,20052,4.49697241533976
"4460",2006-01-19,6,5,-121.4543656,38.53290497,4460,20057,4.49708520179372
"4461",2006-01-19,2,4,-121.4519681,38.60931329,4461,20061,4.4969737726967
"4462",2006-01-19,3,6,-121.4876958,38.57815667,4462,20067,4.497310623039
"4463",2006-01-19,6,6,-121.4254625,38.54146972,4463,20073,4.49764732242886
"4464",2006-01-19,6,1,-121.4391618,38.54672128,4464,20074,4.49686379928315
"4465",2006-01-19,4,2,-121.5093921,38.56020985,4465,20076,4.4963045912654
"4466",2006-01-19,5,7,-121.4190329,38.43922779,4466,20083,4.49686520376176
"4467",2006-01-19,4,1,-121.490311,38.50785295,4467,20084,4.4960823819118
"4468",2006-01-19,5,3,-121.5010455,38.48550389,4468,20087,4.49574753804834
"4469",2006-01-19,6,3,-121.4091585,38.53479183,4469,20090,4.4954128440367
"4470",2006-01-19,2,5,-121.4280294,38.62821323,4470,20095,4.49552572706935
"4471",2006-01-19,3,1,-121.4860731,38.57955265,4471,20096,4.49474390516663
"4472",2006-01-19,4,1,-121.4883749,38.56053898,4472,20097,4.49396243291592
"4473",2006-01-19,6,7,-121.4139189,38.50938028,4473,20104,4.49452269170579
"4474",2006-01-19,5,3,-121.4876867,38.48883395,4474,20107,4.49418864550738
"4475",2006-01-19,1,2,-121.4922453,38.6157219,4475,20109,4.4936312849162
"4476",2006-01-19,4,4,-121.5255605,38.51538948,4476,20113,4.49352100089366
"4477",2006-01-19,3,7,-121.4906079,38.58233236,4477,20120,4.49408085771722
"4478",2006-01-19,3,7,-121.4167663,38.56210598,4478,20127,4.49464046449308
"4479",2006-01-19,4,3,-121.5209353,38.51036458,4479,20130,4.49430676490288
"4480",2006-01-19,2,3,-121.4211472,38.60666454,4480,20133,4.49397321428571
"4481",2006-01-19,5,1,-121.444819,38.44292155,4481,20134,4.49319348359741
"4482",2006-01-19,2,6,-121.4539902,38.60757642,4482,20140,4.49352967425257
"4483",2006-01-19,3,1,-121.474084,38.57635196,4483,20141,4.4927503903636
"4484",2006-01-19,3,4,-121.4978798,38.59540732,4484,20145,4.49264049955397
"4485",2006-01-19,3,1,-121.4825556,38.57740339,4485,20146,4.49186176142698
"4486",2006-01-19,3,3,-121.4962474,38.57734295,4486,20149,4.49152920196166
"4487",2006-01-19,3,1,-121.496127,38.58102199,4487,20150,4.49075105861377
"4488",2006-01-19,6,3,-121.4254625,38.54146972,4488,20153,4.49041889483066
"4489",2006-01-19,3,7,-121.4064774,38.55156962,4489,20160,4.49097794609044
"4490",2006-01-19,2,4,-121.4271758,38.60244653,4490,20164,4.49086859688196
"4491",2006-01-19,6,3,-121.4606267,38.54679037,4491,20167,4.49053662881318
"4492",2006-01-19,2,1,-121.4258271,38.6017616,4492,20168,4.48975957257346
"4493",2006-01-19,1,7,-121.4836423,38.63410636,4493,20175,4.49031827286891
"4494",2006-01-19,5,8,-121.4324958,38.45896393,4494,20183,4.49109924343569
"4495",2006-01-19,5,1,-121.4859396,38.48934244,4495,20184,4.49032258064516
"4496",2006-01-19,6,1,-121.4086008,38.52023542,4496,20185,4.4895462633452
"4497",2006-01-19,6,3,-121.466141,38.54723881,4497,20188,4.48921503224372
"4498",2006-01-19,3,1,-121.4866532,38.57478278,4498,20189,4.48843930635838
"4499",2006-01-19,4,2,-121.5427657,38.51006027,4499,20191,4.48788619693265
"4500",2006-01-19,4,5,-121.522571,38.49518358,4500,20196,4.488
"4501",2006-01-19,2,5,-121.4576083,38.61960417,4501,20201,4.48811375249944
"4502",2006-01-19,6,8,-121.4708274,38.54097213,4502,20209,4.48889382496668
"4503",2006-01-19,5,6,-121.4673944,38.49407763,4503,20215,4.48922940262048
"4504",2006-01-19,4,3,-121.5346969,38.50298477,4504,20218,4.48889875666075
"4505",2006-01-19,5,4,-121.5029365,38.48285946,4505,20222,4.48879023307436
"4506",2006-01-19,6,1,-121.4091236,38.52506274,4506,20223,4.48801597869507
"4507",2006-01-19,5,1,-121.4859396,38.48934244,4507,20224,4.48724206789439
"4508",2006-01-19,2,6,-121.4433216,38.62800488,4508,20230,4.48757763975155
"4509",2006-01-19,5,3,-121.4581108,38.47474149,4509,20233,4.48724772676869
"4510",2006-01-19,5,3,-121.5029365,38.48285946,4510,20236,4.48691796008869
"4511",2006-01-19,3,3,-121.3891646,38.56055493,4511,20239,4.48658833961428
"4512",2006-01-19,3,8,-121.5001574,38.58295887,4512,20247,4.4873670212766
"4513",2006-01-19,3,8,-121.4290297,38.5548986,4513,20255,4.48814535785509
"4514",2006-01-19,2,4,-121.4258271,38.6017616,4514,20259,4.48803721754541
"4515",2006-01-19,6,5,-121.4594919,38.55719769,4515,20264,4.48815060908084
"4516",2006-01-19,4,7,-121.4818823,38.5593266,4516,20271,4.48870682019486
"4517",2006-01-19,2,7,-121.4530163,38.61410168,4517,20278,4.48926278503431
"4518",2006-01-19,3,2,-121.4726096,38.5775315,4518,20280,4.48871181938911
"4519",2006-01-19,2,1,-121.4271758,38.60244653,4519,20281,4.48793980969241
"4520",2006-01-19,4,4,-121.4827348,38.49575914,4520,20285,4.48783185840708
"4521",2006-01-19,2,6,-121.3815598,38.63862878,4521,20291,4.48816633488166
"4522",2006-01-19,3,5,-121.4956541,38.58211006,4522,20296,4.48827952233525
"4523",2006-01-19,5,4,-121.4711245,38.49380643,4523,20300,4.48817156754367
"4524",2006-01-19,3,5,-121.4062379,38.56816494,4524,20305,4.48828470380194
"4525",2006-01-19,6,4,-121.4358127,38.51700756,4525,20309,4.48817679558011
"4526",2006-01-19,3,1,-121.4912825,38.57849376,4526,20310,4.48740609809987
"4527",2006-01-19,4,1,-121.4717471,38.52488785,4527,20311,4.4866357411089
"4528",2006-01-19,3,1,-121.5052755,38.58245363,4528,20312,4.48586572438163
"4529",2006-01-19,5,3,-121.4378156,38.46549508,4529,20315,4.48553764627953
"4530",2006-01-19,3,1,-121.491759,38.57739748,4530,20316,4.48476821192053
"4531",2006-01-19,6,6,-121.4671236,38.55472055,4531,20322,4.4851026263518
"4532",2006-01-19,4,3,-121.5008974,38.52270247,4532,20325,4.48477493380406
"4533",2006-01-19,5,5,-121.4933503,38.48140918,4533,20330,4.48488859474961
"4534",2006-01-19,5,4,-121.4281268,38.47295223,4534,20334,4.48478164975739
"4535",2006-01-19,4,1,-121.5247086,38.49372331,4535,20335,4.48401323042999
"4536",2006-01-19,6,5,-121.4684754,38.52957118,4536,20340,4.48412698412698
"4537",2006-01-19,2,7,-121.4378627,38.5971141,4537,20347,4.48468150760414
"4538",2006-01-19,3,3,-121.39233,38.54737452,4538,20350,4.48435434111944
"4539",2006-01-19,3,6,-121.4006742,38.56595598,4539,20356,4.4846882573254
"4540",2006-01-19,5,1,-121.4803373,38.48142831,4540,20357,4.48392070484581
"4541",2006-01-19,2,1,-121.4258406,38.62529444,4541,20358,4.48315349042061
"4542",2006-01-19,3,1,-121.4892102,38.57917936,4542,20359,4.48238661382651
"4543",2006-01-19,3,1,-121.4798128,38.58032651,4543,20360,4.48162007484041
"4544",2006-01-19,2,6,-121.3815598,38.63862878,4544,20366,4.48195422535211
"4545",2006-01-19,3,1,-121.4713211,38.56211814,4545,20367,4.48118811881188
"4546",2006-01-19,3,1,-121.4987072,38.5797426,4546,20368,4.48042234931808
"4547",2006-01-19,5,7,-121.4851106,38.48220754,4547,20375,4.48097646800088
"4548",2006-01-19,4,3,-121.5076046,38.49793266,4548,20378,4.4806508355321
"4549",2006-01-19,5,8,-121.4101087,38.44772249,4549,20386,4.48142448889866
"4550",2006-01-19,1,7,-121.4959999,38.63020663,4550,20393,4.48197802197802
"4551",2006-01-19,4,3,-121.4831689,38.50289229,4551,20396,4.48165238409141
"4552",2006-01-19,4,1,-121.4912641,38.49572558,4552,20397,4.48088752196837
"4553",2006-01-19,6,4,-121.461558,38.53921315,4553,20401,4.48078190204261
"4554",2006-01-19,5,4,-121.4355908,38.47345298,4554,20405,4.48067632850242
"4555",2006-01-19,6,7,-121.4418771,38.543788,4555,20412,4.48122941822173
"4556",2006-01-19,3,3,-121.5043854,38.58468227,4556,20415,4.48090430201932
"4557",2006-01-19,6,2,-121.4121265,38.50890986,4557,20417,4.48035988588984
"4558",2006-01-19,3,2,-121.4880901,38.57147205,4558,20419,4.47981570864414
"4559",2006-01-19,3,8,-121.4625542,38.56617746,4559,20427,4.48058784821233
"4560",2006-01-19,4,4,-121.4972545,38.56201402,4560,20431,4.48048245614035
"4561",2006-01-19,2,1,-121.4473381,38.61112009,4561,20432,4.47971935978952
"4562",2006-01-19,4,5,-121.515842,38.51881458,4562,20437,4.4798334064007
"4563",2006-01-19,4,3,-121.4737197,38.49580633,4563,20440,4.47950909489371
"4564",2006-01-19,5,7,-121.4189709,38.47433721,4564,20447,4.48006134969325
"4565",2006-01-19,1,1,-121.4790946,38.6101634,4565,20448,4.47929901423877
"4566",2006-01-19,3,1,-121.4892102,38.57917936,4566,20449,4.47853701270258
"4567",2006-01-19,5,4,-121.4564502,38.48915265,4567,20453,4.478432231224
"4568",2006-01-19,1,7,-121.5127092,38.61731183,4568,20460,4.47898423817863
"4569",2006-01-19,3,1,-121.4983043,38.5828163,4569,20461,4.47822280586562
"4570",2006-01-19,2,1,-121.4500323,38.61663853,4570,20462,4.47746170678337
"4571",2006-01-19,3,1,-121.5014996,38.58062786,4571,20463,4.47670094071319
"4572",2006-01-19,3,5,-121.4854695,38.56623766,4572,20468,4.47681539807524
"4573",2006-01-19,6,4,-121.3788285,38.5245855,4573,20472,4.47671113054887
"4574",2006-01-19,3,4,-121.4797077,38.57506207,4574,20476,4.4766069086139
"4575",2006-01-19,5,2,-121.43386,38.47059147,4575,20478,4.47606557377049
"4576",2006-01-19,4,1,-121.5346969,38.50298477,4576,20479,4.47530594405594
"4577",2006-01-19,1,2,-121.4812714,38.60728719,4577,20481,4.47476512999781
"4578",2006-01-19,2,5,-121.4564534,38.61085293,4578,20486,4.47487986020096
"4579",2006-01-19,2,1,-121.4276865,38.62558366,4579,20487,4.47412098711509
"4580",2006-01-19,6,5,-121.4129023,38.51018792,4580,20492,4.47423580786026
"4581",2006-01-19,6,9,-121.4650574,38.5392541,4581,20501,4.47522375027287
"4582",2006-01-19,2,5,-121.4164146,38.63248017,4582,20506,4.47533828022697
"4583",2006-01-19,5,7,-121.4411594,38.47334822,4583,20513,4.47588915557495
"4584",2006-01-19,2,2,-121.4247939,38.6196628,4584,20515,4.47534904013962
"4585",2006-01-19,3,5,-121.4747617,38.56791951,4585,20520,4.47546346782988
"4586",2006-01-19,5,7,-121.4226457,38.44925489,4586,20527,4.47601395551679
"4587",2006-01-19,3,7,-121.4830358,38.57629892,4587,20534,4.47656420318291
"4588",2006-01-19,6,3,-121.420355,38.52201663,4588,20537,4.47624237140366
"4589",2006-01-19,6,6,-121.4667271,38.53992632,4589,20543,4.47657441708433
"4590",2006-01-19,2,5,-121.4477449,38.66207022,4590,20548,4.47668845315904
"4591",2006-01-19,3,2,-121.4930954,38.56457981,4591,20550,4.47614898714877
"4592",2006-01-19,3,7,-121.4821859,38.57484527,4592,20557,4.47669860627178
"4593",2006-01-19,5,6,-121.4096613,38.44862637,4593,20563,4.47703026344437
"4594",2006-01-19,1,1,-121.5215208,38.67279982,4594,20564,4.47627340008707
"4595",2006-01-19,4,5,-121.5356952,38.4848876,4595,20569,4.47638737758433
"4596",2006-01-19,2,4,-121.4581238,38.64479784,4596,20573,4.47628372497824
"4597",2006-01-19,2,4,-121.4378757,38.61632755,4597,20577,4.47618011746791
"4598",2006-01-19,2,3,-121.4336789,38.64193226,4598,20580,4.4758590691605
"4599",2006-01-19,3,3,-121.4784756,38.57996901,4599,20583,4.47553816046967
"4600",2006-01-19,3,5,-121.5051437,38.57724403,4600,20588,4.47565217391304
"4601",2006-01-19,3,7,-121.4890397,38.5692795,4601,20595,4.47620082590741
"4602",2006-01-19,4,4,-121.4972545,38.56201402,4602,20599,4.4760973489787
"4603",2006-01-19,5,7,-121.4940415,38.49281883,4603,20606,4.47664566587008
"4604",2006-01-19,3,5,-121.4192296,38.57227839,4604,20611,4.4767593397046
"4605",2006-01-19,2,2,-121.45969,38.60909145,4605,20613,4.47622149837134
"4606",2006-01-19,2,7,-121.4170159,38.64028718,4606,20620,4.47676943117673
"4607",2006-01-19,6,5,-121.4704533,38.53673892,4607,20625,4.47688300412416
"4608",2006-01-19,3,7,-121.4839488,38.5719397,4608,20632,4.47743055555556
"4609",2006-01-19,1,1,-121.4970061,38.67117206,4609,20633,4.47667606856151
"4610",2006-01-19,3,8,-121.4800882,38.570857,4610,20641,4.47744034707158
"4611",2006-01-19,3,2,-121.4745188,38.58048383,4611,20643,4.47690305790501
"4612",2006-01-19,5,1,-121.4271773,38.4706931,4612,20644,4.47614917606245
"4613",2006-01-19,3,5,-121.4658077,38.56560764,4613,20649,4.4762627357468
"4614",2006-01-19,4,5,-121.4965275,38.52676399,4614,20654,4.4763762462072
"4615",2006-01-19,6,5,-121.4693358,38.55302823,4615,20659,4.47648970747562
"4616",2006-01-19,6,7,-121.4693358,38.55302823,4616,20666,4.47703639514731
"4617",2006-01-19,1,7,-121.4752572,38.62229136,4617,20673,4.4775828460039
"4618",2006-01-19,2,5,-121.4512963,38.6047491,4618,20678,4.47769597228237
"4619",2006-01-19,3,7,-121.4711377,38.56940229,4619,20685,4.47824204373241
"4620",2006-01-19,6,3,-121.4431889,38.52532233,4620,20688,4.47792207792208
"4621",2006-01-19,2,6,-121.3815598,38.63862878,4621,20694,4.47825146072279
"4622",2006-01-19,5,5,-121.4796842,38.48716439,4622,20699,4.47836434443964
"4623",2006-01-19,6,5,-121.4523277,38.55612056,4623,20704,4.47847717932079
"4624",2006-01-19,3,4,-121.4825623,38.58129991,4624,20708,4.47837370242215
"4625",2006-01-19,5,7,-121.4616086,38.49682424,4625,20715,4.47891891891892
"4626",2006-01-19,2,2,-121.4303283,38.63228581,4626,20717,4.47838305231301
"4627",2006-01-19,1,5,-121.4805674,38.60880803,4627,20722,4.47849578560622
"4628",2006-01-19,5,4,-121.4578294,38.48466401,4628,20726,4.47839239412273
"4629",2006-01-19,3,4,-121.4710327,38.57035191,4629,20730,4.47828904731043
"4630",2006-01-19,3,4,-121.4648897,38.57188611,4630,20734,4.47818574514039
"4631",2006-01-19,5,3,-121.4247312,38.46736384,4631,20737,4.47786655150076
"4632",2006-01-19,3,5,-121.4910186,38.56987859,4632,20742,4.4779792746114
"4633",2006-01-19,5,2,-121.4722254,38.48005429,4633,20744,4.4774444204619
"4634",2006-01-19,4,7,-121.5458865,38.48918152,4634,20751,4.47798877859301
"4635",2006-01-19,3,5,-121.4679798,38.56979971,4635,20756,4.47810140237325
"4636",2006-01-19,1,5,-121.5170835,38.64790058,4636,20761,4.47821397756687
"4637",2006-01-19,6,3,-121.4646263,38.52495123,4637,20764,4.47789519085616
"4638",2006-01-19,5,6,-121.4296391,38.45721442,4638,20770,4.47822337214317
"4639",2006-01-19,1,5,-121.4966948,38.62648616,4639,20775,4.47833584824316
"4640",2006-01-19,2,5,-121.4612527,38.64729201,4640,20780,4.47844827586207
"4641",2006-01-19,5,6,-121.4771048,38.48301736,4641,20786,4.47877612583495
"4642",2006-01-19,3,7,-121.4864458,38.58366772,4642,20793,4.47931925894011
"4643",2006-01-19,4,1,-121.4791546,38.49942812,4643,20794,4.47856989015723
"4644",2006-01-19,6,8,-121.4425904,38.52497346,4644,20802,4.47932816537468
"4645",2006-01-19,3,5,-121.4864344,38.57941421,4645,20807,4.4794402583423
"4646",2006-01-19,5,3,-121.456359,38.48461318,4646,20810,4.479121825226
"4647",2006-01-19,1,8,-121.4873311,38.63036355,4647,20818,4.47987949214547
"4648",2006-01-19,4,1,-121.4881786,38.50793689,4648,20819,4.47913080895009
"4649",2006-01-19,4,3,-121.4957557,38.53555587,4649,20822,4.47881264788126
"4650",2006-01-20,3,7,-121.4963828,38.57898287,4650,20829,4.47935483870968
"4651",2006-01-20,2,7,-121.4605138,38.65701743,4651,20836,4.47989679638787
"4652",2006-01-20,2,4,-121.4266349,38.61444639,4652,20840,4.47979363714531
"4653",2006-01-20,3,6,-121.4673661,38.58031934,4653,20846,4.48012035246078
"4654",2006-01-20,5,5,-121.4352539,38.46879146,4654,20851,4.48023205844435
"4655",2006-01-20,2,2,-121.42747,38.60154457,4655,20853,4.4796992481203
"4656",2006-01-20,3,7,-121.5013436,38.57691743,4656,20860,4.48024054982818
"4657",2006-01-20,3,7,-121.4062379,38.56816494,4657,20867,4.48078161906807
"4658",2006-01-20,4,7,-121.5089338,38.55006991,4658,20874,4.4813224559897
"4659",2006-01-20,1,7,-121.4961379,38.61117241,4659,20881,4.48186306074265
"4660",2006-01-20,5,7,-121.4620097,38.48718235,4660,20888,4.48240343347639
"4661",2006-01-20,3,5,-121.3918668,38.55207317,4661,20893,4.48251448187084
"4662",2006-01-20,3,4,-121.4827802,38.57005626,4662,20897,4.48241098241098
"4663",2006-01-20,3,7,-121.4622017,38.58138835,4663,20904,4.48295088998499
"4664",2006-01-20,2,4,-121.4646522,38.65574053,4664,20908,4.48284734133791
"4665",2006-01-20,2,7,-121.4538321,38.63506804,4665,20915,4.48338692390139
"4666",2006-01-20,2,9,-121.4514665,38.63995013,4666,20924,4.48435490784398
"4667",2006-01-20,2,4,-121.4455173,38.61528522,4667,20928,4.48425112491965
"4668",2006-01-20,3,7,-121.4827802,38.57005626,4668,20935,4.48479005998286
"4669",2006-01-20,4,3,-121.5085583,38.54569404,4669,20938,4.48447204968944
"4670",2006-01-20,1,3,-121.4671502,38.61110858,4670,20941,4.48415417558887
"4671",2006-01-20,6,7,-121.4661451,38.55136324,4671,20948,4.48469278527082
"4672",2006-01-20,1,7,-121.5132636,38.61351653,4672,20955,4.48523116438356
"4673",2006-01-20,1,3,-121.5190123,38.61840634,4673,20958,4.4849133319067
"4674",2006-01-20,6,2,-121.4671318,38.55128541,4674,20960,4.48438168592212
"4675",2006-01-20,5,2,-121.4227089,38.47428454,4675,20962,4.48385026737968
"4676",2006-01-20,1,1,-121.5180428,38.61737258,4676,20963,4.48310521813516
"4677",2006-01-20,3,4,-121.4785138,38.56804356,4677,20967,4.48300192431046
"4678",2006-01-20,5,7,-121.4436724,38.4735965,4678,20974,4.48353997434801
"4679",2006-01-20,5,6,-121.4988143,38.48134512,4679,20980,4.48386407351998
"4680",2006-01-20,5,5,-121.4409071,38.47390443,4680,20985,4.48397435897436
"4681",2006-01-20,2,2,-121.4268957,38.64470526,4681,20987,4.48344370860927
"4682",2006-01-20,5,5,-121.4546419,38.47431603,4682,20992,4.48355403673644
"4683",2006-01-20,3,7,-121.4633604,38.56640912,4683,20999,4.4840913944053
"4684",2006-01-20,4,7,-121.523571,38.49980087,4684,21006,4.48462852263023
"4685",2006-01-20,1,7,-121.4745819,38.64316291,4685,21013,4.48516542155816
"4686",2006-01-20,4,1,-121.4885025,38.55151914,4686,21014,4.48442168160478
"4687",2006-01-20,6,5,-121.4090938,38.54218087,4687,21019,4.48453168337956
"4688",2006-01-20,2,7,-121.4626063,38.65909484,4688,21026,4.48506825938567
"4689",2006-01-20,3,8,-121.4030188,38.55703001,4689,21034,4.48581787161442
"4690",2006-01-20,2,5,-121.4620787,38.60140844,4690,21039,4.48592750533049
"4691",2006-01-20,1,5,-121.4864485,38.61633341,4691,21044,4.48603709230441
"4692",2006-01-20,2,3,-121.4303283,38.63228581,4692,21047,4.48572037510656
"4693",2006-01-20,5,5,-121.440391,38.4653181,4693,21052,4.48582995951417
"4694",2006-01-20,5,8,-121.4404134,38.46602667,4694,21060,4.48657861099276
"4695",2006-01-20,4,1,-121.4755412,38.49852485,4695,21061,4.48583599574015
"4696",2006-01-20,5,6,-121.4800234,38.48760526,4696,21067,4.48615843270869
"4697",2006-01-20,1,5,-121.4853477,38.633065,4697,21072,4.48626783053013
"4698",2006-01-20,4,5,-121.4848172,38.53500243,4698,21077,4.48637718177948
"4699",2006-01-20,5,7,-121.4308075,38.47143596,4699,21084,4.48691210895935
"4700",2006-01-20,3,3,-121.4984069,38.5791674,4700,21087,4.48659574468085
"4701",2006-01-20,2,5,-121.4223802,38.61041617,4701,21092,4.48670495639226
"4702",2006-01-20,4,2,-121.5364964,38.48416589,4702,21094,4.4861760952786
"4703",2006-01-20,3,3,-121.496374,38.60103545,4703,21097,4.4858600893047
"4704",2006-01-20,3,7,-121.3992939,38.54961314,4704,21104,4.48639455782313
"4705",2006-01-20,3,2,-121.4835098,38.59102751,4705,21106,4.48586609989373
"4706",2006-01-20,5,6,-121.4373604,38.45321298,4706,21112,4.48618784530387
"4707",2006-01-20,1,5,-121.5154134,38.61596119,4707,21117,4.48629700446144
"4708",2006-01-20,3,5,-121.4251815,38.5533528,4708,21122,4.48640611724724
"4709",2006-01-20,2,7,-121.428087,38.623647,4709,21129,4.48693990231472
"4710",2006-01-20,2,3,-121.4429437,38.62170113,4710,21132,4.48662420382166
"4711",2006-01-20,3,7,-121.4643599,38.56511217,4711,21139,4.48715771598387
"4712",2006-01-20,2,5,-121.4579336,38.59891228,4712,21144,4.48726655348048
"4713",2006-01-20,4,5,-121.4771018,38.50060236,4713,21149,4.487375344791
"4714",2006-01-20,3,8,-121.4659619,38.57209976,4714,21157,4.48812049215104
"4715",2006-01-20,4,3,-121.4739308,38.54115653,4715,21160,4.48780487804878
"4716",2006-01-20,6,1,-121.4705253,38.53362535,4716,21161,4.48706530958439
"4717",2006-01-20,2,6,-121.3815598,38.63862878,4717,21167,4.4873860504558
"4718",2006-01-20,6,6,-121.415442,38.52055303,4718,21173,4.48770665536244
"4719",2006-01-20,4,1,-121.474349,38.5019299,4719,21174,4.48696757787667
"4720",2006-01-20,2,2,-121.4325151,38.6390241,4720,21176,4.4864406779661
"4721",2006-01-20,5,5,-121.476798,38.47481934,4721,21181,4.4865494598602
"4722",2006-01-20,5,5,-121.4684313,38.48151147,4722,21186,4.4866581956798
"4723",2006-01-20,1,1,-121.4755357,38.61726206,4723,21187,4.48591996612323
"4724",2006-01-20,4,1,-121.4715167,38.52627076,4724,21188,4.48518204911092
"4725",2006-01-20,3,5,-121.4690268,38.57294038,4725,21193,4.48529100529101
"4726",2006-01-20,2,4,-121.4656067,38.64754283,4726,21197,4.48518831993229
"4727",2006-01-20,2,5,-121.4149332,38.63638293,4727,21202,4.48529722868627
"4728",2006-01-20,4,1,-121.4721784,38.52659231,4728,21203,4.48456006768189
"4729",2006-01-20,6,4,-121.437393,38.51382995,4729,21207,4.48445760203003
"4730",2006-01-20,2,1,-121.446705,38.61242963,4730,21208,4.48372093023256
"4731",2006-01-20,4,1,-121.4757904,38.54168395,4731,21209,4.48298456985838
"4732",2006-01-20,4,1,-121.4779717,38.49967816,4732,21210,4.48224852071006
"4733",2006-01-20,4,5,-121.5008042,38.54402702,4733,21215,4.48235791252905
"4734",2006-01-20,5,4,-121.4834231,38.4860965,4734,21219,4.48225602027883
"4735",2006-01-20,6,1,-121.4383522,38.51585289,4735,21220,4.48152059134108
"4736",2006-01-20,6,7,-121.4688136,38.52875444,4736,21227,4.48205236486486
"4737",2006-01-20,2,4,-121.4276508,38.59994183,4737,21231,4.48195060164661
"4738",2006-01-20,2,7,-121.4220492,38.62102212,4738,21238,4.4824820599409
"4739",2006-01-20,6,5,-121.4258249,38.54552729,4739,21243,4.48259126397974
"4740",2006-01-20,2,1,-121.4514665,38.63995013,4740,21244,4.48185654008439
"4741",2006-01-20,4,1,-121.4771032,38.50089069,4741,21245,4.48112212613373
"4742",2006-01-20,2,5,-121.4592598,38.61782428,4742,21250,4.4812315478701
"4743",2006-01-20,1,3,-121.5105746,38.6361152,4743,21253,4.4809192494202
"4744",2006-01-20,6,1,-121.4653678,38.55196925,4744,21254,4.48018549747049
"4745",2006-01-20,2,5,-121.4294691,38.63640599,4745,21259,4.48029504741833
"4746",2006-01-20,6,5,-121.4163996,38.5269834,4746,21264,4.48040455120101
"4747",2006-01-20,6,5,-121.4397787,38.52648113,4747,21269,4.48051400884769
"4748",2006-01-20,4,1,-121.4753422,38.5393973,4748,21270,4.47978096040438
"4749",2006-01-20,5,7,-121.4300376,38.45803743,4749,21277,4.48031164455675
"4750",2006-01-20,1,7,-121.5385163,38.6533205,4750,21284,4.48084210526316
"4751",2006-01-20,4,1,-121.4741684,38.53452891,4751,21285,4.48010945064197
"4752",2006-01-20,4,1,-121.4755662,38.54031271,4752,21286,4.4793771043771
"4753",2006-01-20,4,7,-121.546318,38.49055344,4753,21293,4.47990742688828
"4754",2006-01-20,3,4,-121.4893717,38.56784758,4754,21297,4.47980647875473
"4755",2006-01-20,4,1,-121.47576,38.54106323,4755,21298,4.47907465825447
"4756",2006-01-20,2,5,-121.4432093,38.62534078,4756,21303,4.47918418839361
"4757",2006-01-20,6,4,-121.4526562,38.54611863,4757,21307,4.47908345595964
"4758",2006-01-20,6,5,-121.4480405,38.53801264,4758,21312,4.47919293820933
"4759",2006-01-20,2,5,-121.4311007,38.6245378,4759,21317,4.47930237444841
"4760",2006-01-20,4,2,-121.4737407,38.53137462,4760,21319,4.47878151260504
"4761",2006-01-20,6,7,-121.427517,38.52507559,4761,21326,4.47931106910313
"4762",2006-01-20,2,7,-121.4244182,38.61199425,4762,21333,4.47984040319194
"4763",2006-01-20,3,7,-121.4754391,38.57141267,4763,21340,4.48036951501155
"4764",2006-01-20,4,3,-121.4937694,38.53514629,4764,21343,4.48005877413938
"4765",2006-01-20,3,6,-121.4144993,38.54983935,4765,21349,4.4803777544596
"4766",2006-01-20,4,3,-121.4960208,38.55199422,4766,21352,4.48006714225766
"4767",2006-01-20,2,5,-121.4278856,38.60687102,4767,21357,4.48017621145374
"4768",2006-01-20,3,7,-121.5022303,38.59723293,4768,21364,4.48070469798658
"4769",2006-01-20,3,5,-121.4566154,38.57122973,4769,21369,4.48081358775425
"4770",2006-01-20,4,6,-121.5076046,38.49793266,4770,21375,4.4811320754717
"4771",2006-01-20,4,1,-121.4739615,38.53366299,4771,21376,4.48040243135611
"4772",2006-01-20,1,3,-121.4959999,38.63020663,4772,21379,4.4800922045264
"4773",2006-01-20,6,2,-121.4431441,38.51135897,4773,21381,4.47957259585167
"4774",2006-01-20,4,4,-121.5219586,38.49324791,4774,21385,4.47947214076246
"4775",2006-01-20,2,7,-121.4308301,38.6308137,4775,21392,4.48
"4776",2006-01-20,5,1,-121.4859396,38.48934244,4776,21393,4.47927135678392
"4777",2006-01-20,2,5,-121.4308562,38.64202003,4777,21398,4.47938036424534
"4778",2006-01-20,6,4,-121.4513126,38.52531996,4778,21402,4.47928003348681
"4779",2006-01-20,5,3,-121.4859396,38.48934244,4779,21405,4.47897049591965
"4780",2006-01-20,4,1,-121.4728534,38.53364422,4780,21406,4.47824267782427
"4781",2006-01-20,5,9,-121.4673944,38.49407763,4781,21415,4.47918845429826
"4782",2006-01-20,4,5,-121.4852422,38.56090952,4782,21420,4.4792973651192
"4783",2006-01-20,5,5,-121.4847635,38.47995982,4783,21425,4.47940623039933
"4784",2006-01-20,1,4,-121.5161468,38.65847399,4784,21429,4.47930602006689
"4785",2006-01-20,4,7,-121.4908853,38.5488551,4785,21436,4.47983281086729
"4786",2006-01-20,5,3,-121.4673944,38.49407763,4786,21439,4.47952361053071
"4787",2006-01-20,2,5,-121.4251306,38.62521129,4787,21444,4.47963233758095
"4788",2006-01-20,5,5,-121.4603052,38.47972466,4788,21449,4.4797410192147
"4789",2006-01-20,2,1,-121.4271758,38.60244653,4789,21450,4.47901440801838
"4790",2006-01-20,2,2,-121.446157,38.62215314,4790,21452,4.47849686847599
"4791",2006-01-20,3,7,-121.4340748,38.56738175,4791,21459,4.47902316844083
"4792",2006-01-20,3,5,-121.5073808,38.57899998,4792,21464,4.47913188647746
"4793",2006-01-20,6,3,-121.467509,38.55040844,4793,21467,4.47882328395577
"4794",2006-01-20,3,1,-121.4059393,38.54857652,4794,21468,4.47809762202753
"4795",2006-01-20,3,3,-121.4809362,38.58794604,4795,21471,4.47778936392075
"4796",2006-01-20,2,6,-121.4518907,38.62029669,4796,21477,4.47810675562969
"4797",2006-01-20,5,7,-121.4348784,38.47431447,4797,21484,4.47863247863248
"4798",2006-01-20,4,2,-121.4883749,38.56053898,4798,21486,4.47811588161734
"4799",2006-01-20,6,6,-121.4548871,38.54519279,4799,21492,4.47843300687643
"4800",2006-01-20,6,7,-121.4256917,38.52862804,4800,21499,4.47895833333333
"4801",2006-01-20,6,7,-121.4188976,38.54131886,4801,21506,4.4794834409498
"4802",2006-01-20,6,4,-121.3859186,38.50615678,4802,21510,4.47938359017076
"4803",2006-01-20,6,2,-121.4516733,38.52659579,4803,21512,4.47886737455757
"4804",2006-01-20,3,2,-121.4868341,38.58464151,4804,21514,4.47835137385512
"4805",2006-01-20,6,5,-121.4254625,38.54146972,4805,21519,4.47845993756504
"4806",2006-01-20,6,6,-121.4254625,38.54146972,4806,21525,4.47877652933833
"4807",2006-01-20,2,8,-121.4217162,38.60814196,4807,21533,4.4795090493031
"4808",2006-01-20,6,2,-121.4662305,38.55630084,4808,21535,4.47899334442596
"4809",2006-01-20,6,6,-121.4233403,38.50770592,4809,21541,4.47930962778124
"4810",2006-01-20,5,6,-121.4170895,38.46689445,4810,21547,4.47962577962578
"4811",2006-01-20,5,6,-121.4170895,38.46689445,4811,21553,4.47994180004157
"4812",2006-01-20,5,6,-121.4170895,38.46689445,4812,21559,4.48025768911056
"4813",2006-01-20,1,5,-121.4874449,38.61551678,4813,21564,4.48036567629337
"4814",2006-01-20,2,7,-121.4689877,38.65479391,4814,21571,4.48088907353552
"4815",2006-01-20,4,4,-121.4922242,38.55971842,4815,21575,4.48078920041537
"4816",2006-01-20,4,7,-121.4953461,38.53218208,4816,21582,4.4813122923588
"4817",2006-01-20,3,7,-121.492387,38.57763638,4817,21589,4.48183516711646
"4818",2006-01-20,2,4,-121.4436574,38.61996363,4818,21593,4.48173515981735
"4819",2006-01-20,6,5,-121.4647099,38.54456589,4819,21598,4.48184270595559
"4820",2006-01-20,1,8,-121.4878406,38.62864136,4820,21606,4.48257261410788
"4821",2006-01-20,6,5,-121.4547618,38.54923149,4821,21611,4.48267994192076
"4822",2006-01-20,3,5,-121.4984909,38.57966477,4822,21616,4.48278722521775
"4823",2006-01-20,2,8,-121.4641553,38.60167619,4823,21624,4.48351648351648
"4824",2006-01-20,5,5,-121.4751559,38.48437601,4824,21629,4.48362354892206
"4825",2006-01-20,5,7,-121.4591154,38.49152941,4825,21636,4.48414507772021
"4826",2006-01-20,2,6,-121.4371893,38.62037723,4826,21642,4.48445917944467
"4827",2006-01-20,3,1,-121.4646342,38.57749764,4827,21643,4.48373731095919
"4828",2006-01-20,3,1,-121.4984069,38.5791674,4828,21644,4.48301574150787
"4829",2006-01-20,4,1,-121.4984736,38.56321928,4829,21645,4.48229447090495
"4830",2006-01-20,5,2,-121.4776303,38.49046124,4830,21647,4.48178053830228
"4831",2006-01-20,1,4,-121.4913256,38.61463322,4831,21651,4.48168081142621
"4832",2006-01-20,5,2,-121.4262414,38.46719286,4832,21653,4.48116721854305
"4833",2006-01-20,3,3,-121.4855038,38.58428687,4833,21656,4.48086074901717
"4834",2006-01-20,4,4,-121.5292089,38.51385568,4834,21660,4.48076127430699
"4835",2006-01-20,2,3,-121.4559846,38.6557853,4835,21663,4.48045501551189
"4836",2006-01-20,6,9,-121.4427445,38.54957241,4836,21672,4.48138957816377
"4837",2006-01-20,6,5,-121.4417772,38.5346545,4837,21677,4.48149679553442
"4838",2006-01-20,3,3,-121.4135687,38.5732988,4838,21680,4.48119057461761
"4839",2006-01-20,2,4,-121.42747,38.60154457,4839,21684,4.48109113453193
"4840",2006-01-20,4,5,-121.483171,38.5248104,4840,21689,4.48119834710744
"4841",2006-01-20,6,5,-121.4442473,38.54742956,4841,21694,4.48130551538938
"4842",2006-01-20,6,3,-121.4149264,38.53015852,4842,21697,4.48099958694754
"4843",2006-01-20,5,5,-121.4372193,38.47158269,4843,21702,4.48110675201321
"4844",2006-01-20,6,7,-121.4471706,38.52935875,4844,21709,4.48162675474814
"4845",2006-01-20,4,5,-121.4751893,38.54165651,4845,21714,4.48173374613003
"4846",2006-01-20,2,6,-121.4590823,38.6061587,4846,21720,4.48204704911267
"4847",2006-01-20,6,4,-121.4122314,38.50125193,4847,21724,4.48194759645141
"4848",2006-01-20,1,5,-121.4944315,38.62725615,4848,21729,4.48205445544554
"4849",2006-01-20,6,4,-121.4429168,38.5481069,4849,21733,4.48195504227676
"4850",2006-01-20,6,7,-121.4692395,38.53117557,4850,21740,4.48247422680412
"4851",2006-01-20,5,1,-121.4322221,38.46791712,4851,21741,4.4817563388992
"4852",2006-01-20,5,3,-121.4368769,38.47425283,4852,21744,4.48145094806265
"4853",2006-01-20,2,5,-121.4533842,38.61084673,4853,21749,4.4815577992994
"4854",2006-01-20,5,3,-121.4258719,38.4497213,4854,21752,4.48125257519571
"4855",2006-01-20,6,1,-121.4597445,38.5566387,4855,21753,4.48053553038105
"4856",2006-01-20,1,4,-121.4754743,38.60944135,4856,21757,4.48043657331137
"4857",2006-01-20,4,7,-121.5179147,38.51467138,4857,21764,4.48095532221536
"4858",2006-01-20,3,5,-121.4676235,38.56880953,4858,21769,4.48106216550021
"4859",2006-01-20,3,4,-121.4957638,38.57846394,4859,21773,4.48096316114427
"4860",2006-01-20,3,7,-121.502819,38.57452108,4860,21780,4.48148148148148
"4861",2006-01-20,3,3,-121.4680667,38.58113261,4861,21783,4.48117671261057
"4862",2006-01-20,3,6,-121.4805705,38.57907501,4862,21789,4.48148909913616
"4863",2006-01-20,1,4,-121.5300211,38.61134232,4863,21793,4.48139008842278
"4864",2006-01-20,6,3,-121.4681974,38.53450711,4864,21796,4.48108552631579
"4865",2006-01-20,1,1,-121.4755356,38.62203999,4865,21797,4.48036998972251
"4866",2006-01-20,2,3,-121.4236331,38.60175345,4866,21800,4.48006576243321
"4867",2006-01-20,3,2,-121.4892801,38.58651132,4867,21802,4.47955619478118
"4868",2006-01-20,3,1,-121.4936388,38.58164544,4868,21803,4.47884141331142
"4869",2006-01-20,5,7,-121.4407255,38.4640813,4869,21810,4.47935921133703
"4870",2006-01-20,6,5,-121.3710876,38.52201739,4870,21815,4.47946611909651
"4871",2006-01-20,5,4,-121.4359472,38.47431969,4871,21819,4.47936768630671
"4872",2006-01-20,3,7,-121.415297,38.57411211,4872,21826,4.47988505747126
"4873",2006-01-20,1,5,-121.4967114,38.61471716,4873,21831,4.47999179150421
"4874",2006-01-20,1,4,-121.4960597,38.61035378,4874,21835,4.4798933114485
"4875",2006-01-20,3,7,-121.4749413,38.57203923,4875,21842,4.48041025641026
"4876",2006-01-20,5,7,-121.4408562,38.44559073,4876,21849,4.48092698933552
"4877",2006-01-20,5,1,-121.4807236,38.49220786,4877,21850,4.48021324584786
"4878",2006-01-20,3,8,-121.4886003,38.57007662,4878,21858,4.48093480934809
"4879",2006-01-20,4,3,-121.4830313,38.49727073,4879,21861,4.480631276901
"4880",2006-01-20,5,7,-121.4133413,38.45718227,4880,21868,4.48114754098361
"4881",2006-01-20,5,7,-121.442121,38.48440531,4881,21875,4.48166359352592
"4882",2006-01-20,2,3,-121.4458043,38.61483626,4882,21878,4.48136009832036
"4883",2006-01-20,2,6,-121.45439,38.61250178,4883,21884,4.48167110382961
"4884",2006-01-20,3,8,-121.4978541,38.56675336,4884,21892,4.48239148239148
"4885",2006-01-20,6,7,-121.4608856,38.54445478,4885,21899,4.48290685772774
"4886",2006-01-20,6,1,-121.4728661,38.55513128,4886,21900,4.4821940237413
"4887",2006-01-20,3,5,-121.5008344,38.58370044,4887,21905,4.48229997953755
"4888",2006-01-20,2,6,-121.4641272,38.62729294,4888,21911,4.48261047463175
"4889",2006-01-20,6,2,-121.4658126,38.55093059,4889,21913,4.48210267948456
"4890",2006-01-20,6,2,-121.4652804,38.54775932,4890,21915,4.48159509202454
"4891",2006-01-20,4,7,-121.5468452,38.49335086,4891,21922,4.48210999795543
"4892",2006-01-20,3,5,-121.468649,38.57856783,4892,21927,4.48221586263287
"4893",2006-01-20,6,1,-121.4217494,38.52506613,4893,21928,4.4815041896587
"4894",2006-01-20,3,7,-121.5073808,38.57899998,4894,21935,4.48201879852881
"4895",2006-01-20,3,4,-121.4853853,38.58033768,4895,21939,4.48192032686415
"4896",2006-01-20,4,3,-121.4762678,38.53714433,4896,21942,4.48161764705882
"4897",2006-01-20,1,5,-121.4991088,38.62816341,4897,21947,4.48172350418624
"4898",2006-01-20,2,5,-121.4258885,38.59891162,4898,21952,4.48182931808902
"4899",2006-01-20,2,4,-121.4234663,38.62108959,4899,21956,4.48173096550316
"4900",2006-01-20,5,1,-121.4630104,38.48093723,4900,21957,4.48102040816326
"4901",2006-01-20,1,1,-121.475608,38.60505944,4901,21958,4.48031014078759
"4902",2006-01-20,2,6,-121.456171,38.60108154,4902,21964,4.48062015503876
"4903",2006-01-20,5,7,-121.5013272,38.48269052,4903,21971,4.48113399959209
"4904",2006-01-20,2,4,-121.4404952,38.62149711,4904,21975,4.48103588907015
"4905",2006-01-20,1,5,-121.510115,38.67598139,4905,21980,4.48114169215087
"4906",2006-01-20,3,4,-121.4279016,38.55167203,4906,21984,4.48104362005707
"4907",2006-01-20,3,7,-121.4448793,38.57046834,4907,21991,4.48155695944569
"4908",2006-01-20,5,7,-121.4386328,38.44549208,4908,21998,4.48207008964955
"4909",2006-01-20,1,6,-121.4829071,38.6312171,4909,22004,4.48237930332043
"4910",2006-01-20,1,7,-121.5095127,38.65357208,4910,22011,4.48289205702648
"4911",2006-01-20,1,7,-121.5093788,38.62825953,4911,22018,4.48340460191407
"4912",2006-01-20,4,7,-121.5077495,38.54838986,4912,22025,4.48391693811075
"4913",2006-01-20,4,4,-121.4796512,38.55163345,4913,22029,4.48381844087116
"4914",2006-01-20,2,7,-121.440988,38.59747522,4914,22036,4.48433048433048
"4915",2006-01-20,1,5,-121.5055012,38.6715134,4915,22041,4.48443540183113
"4916",2006-01-20,5,2,-121.4653782,38.49596852,4916,22043,4.48393002441009
"4917",2006-01-20,2,6,-121.4625863,38.65478362,4917,22049,4.48423835672158
"4918",2006-01-20,3,7,-121.4911412,38.56838809,4918,22056,4.48474989833266
"4919",2006-01-20,5,7,-121.4708033,38.48245049,4919,22063,4.48526123195771
"4920",2006-01-20,6,2,-121.4443121,38.52517945,4920,22065,4.48475609756098
"4921",2006-01-20,3,5,-121.4330944,38.56354361,4921,22070,4.48486080065027
"4922",2006-01-20,1,5,-121.4815734,38.62975579,4922,22075,4.48496546119464
"4923",2006-01-20,2,6,-121.4507608,38.61475827,4923,22081,4.48527320739387
"4924",2006-01-21,2,7,-121.3846125,38.6374478,4924,22088,4.48578391551584
"4925",2006-01-21,2,5,-121.3846125,38.6374478,4925,22093,4.4858883248731
"4926",2006-01-21,2,7,-121.4609852,38.63636742,4926,22100,4.48639870077142
"4927",2006-01-21,2,7,-121.4379938,38.59691428,4927,22107,4.48690886949462
"4928",2006-01-21,5,7,-121.4303531,38.44430924,4928,22114,4.48741883116883
"4929",2006-01-21,3,7,-121.4768448,38.56812665,4929,22121,4.48792858592006
"4930",2006-01-21,1,4,-121.5317706,38.63378913,4930,22125,4.48782961460446
"4931",2006-01-21,5,5,-121.426108,38.46423481,4931,22130,4.48793348205232
"4932",2006-01-21,1,5,-121.5085109,38.66325547,4932,22135,4.48803730738037
"4933",2006-01-21,5,5,-121.4982461,38.47620226,4933,22140,4.48814109061423
"4934",2006-01-21,3,7,-121.4603519,38.58036374,4934,22147,4.48865018240778
"4935",2006-01-21,3,7,-121.4979339,38.58026647,4935,22154,4.48915906788247
"4936",2006-01-21,6,4,-121.4546045,38.55426406,4936,22158,4.48905996758509
"4937",2006-01-21,3,8,-121.4861209,38.58166174,4937,22166,4.48977111606239
"4938",2006-01-21,6,7,-121.4336255,38.53893426,4938,22173,4.4902794653706
"4939",2006-01-21,2,6,-121.4461725,38.61294057,4939,22179,4.49058513869204
"4940",2006-01-21,2,3,-121.4523173,38.61670153,4940,22182,4.49028340080972
"4941",2006-01-21,6,3,-121.4587152,38.54526568,4941,22185,4.48998178506375
"4942",2006-01-21,4,3,-121.4830379,38.55911758,4942,22188,4.48968029138001
"4943",2006-01-21,2,5,-121.4491932,38.63827531,4943,22193,4.48978353226785
"4944",2006-01-21,4,7,-121.4912627,38.51063877,4944,22200,4.49029126213592
"4945",2006-01-21,2,1,-121.4308988,38.63887064,4945,22201,4.48958543983822
"4946",2006-01-21,3,8,-121.487703,38.5766684,4946,22209,4.49029518803073
"4947",2006-01-21,6,1,-121.4606716,38.54455538,4947,22210,4.48958965029311
"4948",2006-01-21,5,5,-121.4679029,38.48819542,4948,22215,4.48969280517381
"4949",2006-01-21,3,6,-121.4976906,38.57905171,4949,22221,4.48999797938978
"4950",2006-01-21,1,7,-121.5095127,38.65357208,4950,22228,4.49050505050505
"4951",2006-01-21,4,4,-121.5369556,38.47798938,4951,22232,4.49040597859018
"4952",2006-01-21,1,7,-121.4865252,38.6197799,4952,22239,4.49091276252019
"4953",2006-01-21,1,3,-121.4755923,38.60672341,4953,22242,4.49061175045427
"4954",2006-01-21,1,1,-121.4844292,38.61292222,4954,22243,4.48990714574082
"4955",2006-01-21,5,5,-121.4944916,38.47759732,4955,22248,4.49001009081736
"4956",2006-01-21,3,6,-121.4328333,38.5735211,4956,22254,4.49031476997579
"4957",2006-01-21,4,7,-121.4872809,38.54584611,4957,22261,4.49082106112568
"4958",2006-01-21,6,6,-121.4615322,38.54402942,4958,22267,4.49112545381202
"4959",2006-01-21,6,6,-121.4675766,38.55025224,4959,22273,4.49142972373462
"4960",2006-01-21,3,5,-121.4011901,38.55824526,4960,22278,4.49153225806452
"4961",2006-01-21,2,5,-121.4529281,38.61556485,4961,22283,4.49163475105825
"4962",2006-01-21,4,7,-121.5133337,38.49658669,4962,22290,4.49214026602177
"4963",2006-01-21,3,3,-121.456264,38.5659339,4963,22293,4.49183961313722
"4964",2006-01-21,5,3,-121.4684313,38.48151147,4964,22296,4.49153908138598
"4965",2006-01-21,1,5,-121.5039766,38.62888456,4965,22301,4.49164149043303
"4966",2006-01-21,2,5,-121.4635553,38.62980557,4966,22306,4.491743858236
"4967",2006-01-21,2,4,-121.43778,38.61293858,4967,22310,4.49164485604993
"4968",2006-01-21,3,1,-121.4775582,38.56766855,4968,22311,4.49094202898551
"4969",2006-01-21,3,6,-121.4910186,38.56987859,4969,22317,4.49124572348561
"4970",2006-01-21,3,7,-121.4759072,38.57101937,4970,22324,4.49175050301811
"4971",2006-01-21,2,7,-121.4211729,38.59875634,4971,22331,4.49225507946087
"4972",2006-01-21,6,5,-121.420137,38.51271225,4972,22336,4.4923572003218
"4973",2006-01-21,3,1,-121.4654979,38.57894325,4973,22337,4.49165493665795
"4974",2006-01-21,5,6,-121.466618,38.48107476,4974,22343,4.49195818254926
"4975",2006-01-21,6,3,-121.4437086,38.5241276,4975,22346,4.49165829145729
"4976",2006-01-21,3,3,-121.4676235,38.56880953,4976,22349,4.49135852090032
"4977",2006-01-21,6,5,-121.421083,38.50638208,4977,22354,4.49146071930882
"4978",2006-01-21,4,1,-121.4827348,38.49575914,4978,22355,4.49075934110084
"4979",2006-01-21,5,5,-121.4301095,38.44465403,4979,22360,4.49086161879896
"4980",2006-01-21,2,5,-121.4432674,38.62373194,4980,22365,4.49096385542169
"4981",2006-01-21,1,5,-121.5145574,38.62138631,4981,22370,4.49106605099378
"4982",2006-01-21,2,7,-121.4369307,38.59682949,4982,22377,4.49156965074267
"4983",2006-01-21,5,1,-121.505075,38.48126775,4983,22378,4.49086895444511
"4984",2006-01-21,3,8,-121.4106138,38.55456463,4984,22386,4.49157303370786
"4985",2006-01-21,5,8,-121.4673944,38.49407763,4985,22394,4.49227683049147
"4986",2006-01-21,6,1,-121.4497148,38.53941555,4986,22395,4.49157641395909
"4987",2006-01-21,2,2,-121.4543396,38.60811078,4987,22397,4.49107679967917
"4988",2006-01-21,3,4,-121.4978798,38.59540732,4988,22401,4.49097834803528
"4989",2006-01-21,5,3,-121.4760448,38.49511942,4989,22404,4.49067949488875
"4990",2006-01-21,3,7,-121.505613,38.594323,4990,22411,4.49118236472946
"4991",2006-01-21,6,7,-121.4256917,38.52862804,4991,22418,4.49168503305951
"4992",2006-01-21,3,7,-121.4049517,38.55211647,4992,22425,4.4921875
"4993",2006-01-21,4,5,-121.4972545,38.56201402,4993,22430,4.49228920488684
"4994",2006-01-21,2,1,-121.4631911,38.62795861,4994,22431,4.49158990788947
"4995",2006-01-21,3,6,-121.46491,38.57664767,4995,22437,4.49189189189189
"4996",2006-01-21,1,5,-121.5093137,38.66619701,4996,22442,4.4919935948759
"4997",2006-01-21,2,7,-121.4671856,38.6236879,4997,22449,4.49249549729838
"4998",2006-01-21,2,5,-121.4503031,38.61783155,4998,22454,4.49259703881553
"4999",2006-01-21,5,1,-121.458178,38.48061538,4999,22455,4.49189837967594
"5000",2006-01-21,3,7,-121.4615805,38.57609128,5000,22462,4.4924
"5001",2006-01-21,2,3,-121.3815598,38.63862878,5001,22465,4.49210157968406
"5002",2006-01-21,3,4,-121.4979339,38.58026647,5002,22469,4.49200319872051
"5003",2006-01-21,3,5,-121.4833315,38.58039444,5003,22474,4.4921047371577
"5004",2006-01-21,4,4,-121.4757836,38.50071721,5004,22478,4.49200639488409
"5005",2006-01-21,1,5,-121.5095127,38.65357208,5005,22483,4.49210789210789
"5006",2006-01-21,2,5,-121.4485291,38.61912195,5006,22488,4.49220934878146
"5007",2006-01-21,5,7,-121.4994563,38.4764821,5007,22495,4.492710205712
"5008",2006-01-21,6,4,-121.4559025,38.54041688,5008,22499,4.49261182108626
"5009",2006-01-21,3,3,-121.4878161,38.5857662,5009,22502,4.49231383509683
"5010",2006-01-21,6,2,-121.4435986,38.52433302,5010,22504,4.49181636726547
"5011",2006-01-21,1,2,-121.4679405,38.61118361,5011,22506,4.49131909798443
"5012",2006-01-21,6,7,-121.4331388,38.50557133,5012,22513,4.49181963288109
"5013",2006-01-21,4,5,-121.4915289,38.51153512,5013,22518,4.491921005386
"5014",2006-01-21,6,5,-121.464721,38.54681762,5014,22523,4.49202233745513
"5015",2006-01-21,6,3,-121.4428571,38.52439535,5015,22526,4.49172482552343
"5016",2006-01-21,3,5,-121.4819494,38.58814554,5016,22531,4.49182615629984
"5017",2006-01-21,2,7,-121.42747,38.60154457,5017,22538,4.49232609128962
"5018",2006-01-21,6,7,-121.4456772,38.54159853,5018,22545,4.49282582702272
"5019",2006-01-21,2,6,-121.4418103,38.64844939,5019,22551,4.49312612074118
"5020",2006-01-21,4,7,-121.5216468,38.49024257,5020,22558,4.49362549800797
"5021",2006-01-21,6,5,-121.4621176,38.5382684,5021,22563,4.4937263493328
"5022",2006-01-21,4,6,-121.488389,38.55076075,5022,22569,4.49402628434887
"5023",2006-01-21,5,3,-121.4368769,38.47425283,5023,22572,4.49372884730241
"5024",2006-01-21,5,7,-121.4191049,38.46817048,5024,22579,4.49422770700637
"5025",2006-01-21,2,1,-121.4549149,38.63860717,5025,22580,4.49353233830846
"5026",2006-01-21,2,5,-121.4297591,38.63647881,5026,22585,4.49363310783924
"5027",2006-01-21,6,7,-121.4566752,38.54454492,5027,22592,4.49413168888005
"5028",2006-01-21,2,1,-121.4258271,38.6017616,5028,22593,4.49343675417661
"5029",2006-01-21,4,7,-121.5194794,38.51275848,5029,22600,4.49393517597932
"5030",2006-01-21,5,7,-121.4293793,38.44383213,5030,22607,4.49443339960239
"5031",2006-01-21,2,7,-121.4517802,38.61508987,5031,22614,4.49493142516398
"5032",2006-01-21,4,4,-121.4763166,38.54049185,5032,22618,4.49483306836248
"5033",2006-01-21,6,4,-121.4101581,38.51154968,5033,22622,4.49473475064574
"5034",2006-01-21,5,5,-121.4271773,38.4706931,5034,22627,4.494835121176
"5035",2006-01-21,1,5,-121.4763493,38.63659439,5035,22632,4.49493545183714
"5036",2006-01-21,2,8,-121.4587154,38.64619279,5036,22640,4.49563145353455
"5037",2006-01-21,5,2,-121.4774573,38.48306838,5037,22642,4.49513599364701
"5038",2006-01-21,6,8,-121.4334191,38.54247278,5038,22650,4.49583167923779
"5039",2006-01-21,2,2,-121.42747,38.60154457,5039,22652,4.49533637626513
"5040",2006-01-21,6,6,-121.4266405,38.50842529,5040,22658,4.49563492063492
"5041",2006-01-21,1,4,-121.5134383,38.66741163,5041,22662,4.49553659988098
"5042",2006-01-21,3,3,-121.4885667,38.57037029,5042,22665,4.49523998413328
"5043",2006-01-21,5,3,-121.4372418,38.47271413,5043,22668,4.49494348602023
"5044",2006-01-21,4,7,-121.5083244,38.50452322,5044,22675,4.49544012688343
"5045",2006-01-21,6,4,-121.4298444,38.53608736,5045,22679,4.49534192269574
"5046",2006-01-21,6,1,-121.4639267,38.53944383,5046,22680,4.49464922711058
"5047",2006-01-21,2,5,-121.4273421,38.6253156,5047,22685,4.4947493560531
"5048",2006-01-21,6,4,-121.4703216,38.54976507,5048,22689,4.49465134706815
"5049",2006-01-21,2,3,-121.4301916,38.60032506,5049,22692,4.49435531788473
"5050",2006-01-21,6,3,-121.4077024,38.54426891,5050,22695,4.49405940594059
"5051",2006-01-21,1,3,-121.4752077,38.61284511,5051,22698,4.49376361116611
"5052",2006-01-21,5,8,-121.45711,38.46577952,5052,22706,4.4944576405384
"5053",2006-01-21,5,1,-121.4620303,38.48119903,5053,22707,4.4937660795567
"5054",2006-01-21,5,2,-121.442795,38.46025246,5054,22709,4.49327265532252
"5055",2006-01-21,2,7,-121.4328287,38.63833091,5055,22716,4.49376854599407
"5056",2006-01-21,2,7,-121.42747,38.60154457,5056,22723,4.49426424050633
"5057",2006-01-21,1,7,-121.5096441,38.65941872,5057,22730,4.49475973897568
"5058",2006-01-21,4,6,-121.5247086,38.49372331,5058,22736,4.49505733491499
"5059",2006-01-21,3,5,-121.4854695,38.56623766,5059,22741,4.49515714568096
"5060",2006-01-21,1,9,-121.5048798,38.65407136,5060,22750,4.49604743083004
"5061",2006-01-21,4,7,-121.4870624,38.56018718,5061,22757,4.49654218533887
"5062",2006-01-21,6,1,-121.4476033,38.5249316,5062,22758,4.49585144211774
"5063",2006-01-21,2,6,-121.459947,38.61812954,5063,22764,4.49614852854039
"5064",2006-01-21,3,3,-121.4278339,38.55443686,5064,22767,4.49585308056872
"5065",2006-01-21,2,6,-121.3815598,38.63862878,5065,22773,4.49615004935834
"5066",2006-01-21,5,6,-121.458738,38.47909126,5066,22779,4.49644690090801
"5067",2006-01-21,6,1,-121.4652524,38.54963467,5067,22780,4.49575685810144
"5068",2006-01-21,5,8,-121.491628,38.4814126,5068,22788,4.49644830307814
"5069",2006-01-21,6,1,-121.4348462,38.50708722,5069,22789,4.49575853225488
"5070",2006-01-21,6,3,-121.4700882,38.55624717,5070,22792,4.49546351084813
"5071",2006-01-21,3,3,-121.5062865,38.56779465,5071,22795,4.49516860579767
"5072",2006-01-21,2,6,-121.4432958,38.62234262,5072,22801,4.49546529968454
"5073",2006-01-21,6,4,-121.4109001,38.52073319,5073,22805,4.49536763256456
"5074",2006-01-21,1,5,-121.4954458,38.67486404,5074,22810,4.49546708711076
"5075",2006-01-21,4,1,-121.4960651,38.53085892,5075,22811,4.49477832512315
"5076",2006-01-21,5,1,-121.491628,38.4814126,5076,22812,4.49408983451537
"5077",2006-01-21,4,7,-121.5046051,38.56363012,5077,22819,4.4945834154028
"5078",2006-01-21,5,2,-121.4580233,38.48719669,5078,22821,4.49409216226861
"5079",2006-01-21,5,4,-121.5023861,38.48161867,5079,22825,4.49399488088206
"5080",2006-01-21,2,1,-121.4258271,38.6017616,5080,22826,4.49330708661417
"5081",2006-01-21,4,2,-121.5141544,38.51719838,5081,22828,4.49281637472938
"5082",2006-01-21,6,5,-121.4117693,38.51790104,5082,22833,4.49291617473436
"5083",2006-01-21,1,5,-121.5262517,38.60873755,5083,22838,4.49301593547118
"5084",2006-01-21,3,7,-121.4683488,38.57238808,5084,22845,4.49350904799371
"5085",2006-01-21,2,5,-121.4531127,38.61202895,5085,22850,4.49360865290069
"5086",2006-01-21,3,7,-121.4696858,38.57274295,5086,22857,4.49410145497444
"5087",2006-01-21,1,5,-121.5052917,38.66889839,5087,22862,4.49420090426578
"5088",2006-01-21,6,1,-121.4425904,38.52497346,5088,22863,4.4935141509434
"5089",2006-01-21,3,3,-121.5014426,38.59679019,5089,22866,4.49322067203773
"5090",2006-01-21,6,7,-121.4382578,38.5176373,5090,22873,4.49371316306483
"5091",2006-01-21,3,7,-121.4710298,38.57310333,5091,22880,4.49420546061677
"5092",2006-01-21,4,2,-121.4923822,38.56159185,5092,22882,4.49371563236449
"5093",2006-01-21,3,7,-121.4772314,38.57598179,5093,22889,4.49420773610838
"5094",2006-01-21,3,5,-121.4906793,38.57772224,5094,22894,4.49430702787593
"5095",2006-01-21,1,6,-121.4760509,38.62717997,5095,22900,4.4946025515211
"5096",2006-01-21,2,2,-121.4705911,38.63787804,5096,22902,4.49411302982732
"5097",2006-01-21,6,8,-121.4351666,38.50501284,5097,22910,4.49480086325289
"5098",2006-01-21,5,3,-121.4868595,38.48142174,5098,22913,4.49450765005885
"5099",2006-01-21,1,5,-121.5363135,38.65333642,5099,22918,4.49460678564424
"5100",2006-01-21,5,9,-121.4257964,38.44520109,5100,22927,4.49549019607843
"5101",2006-01-21,6,5,-121.4243909,38.51003423,5101,22932,4.49558910017644
"5102",2006-01-21,2,1,-121.4295032,38.60240036,5102,22933,4.49490395923167
"5103",2006-01-21,3,1,-121.4625542,38.56617746,5103,22934,4.49421908681168
"5104",2006-01-21,1,5,-121.4990928,38.62098272,5104,22939,4.49431818181818
"5105",2006-01-21,2,7,-121.4249294,38.59851693,5105,22946,4.49480901077375
"5106",2006-01-21,5,7,-121.4432125,38.4635908,5106,22953,4.49529964747356
"5107",2006-01-21,1,5,-121.5220302,38.60888221,5107,22958,4.49539847268455
"5108",2006-01-21,5,2,-121.455405,38.48372724,5108,22960,4.49490994518403
"5109",2006-01-21,4,5,-121.4766447,38.55582667,5109,22965,4.49500880798591
"5110",2006-01-21,2,3,-121.4569404,38.63284197,5110,22968,4.49471624266145
"5111",2006-01-21,6,7,-121.4412375,38.53169451,5111,22975,4.49520641753082
"5112",2006-01-21,6,2,-121.4662539,38.54990015,5112,22977,4.49471830985915
"5113",2006-01-21,2,5,-121.4576445,38.65717154,5113,22982,4.49481713279875
"5114",2006-01-21,5,8,-121.4863552,38.49276847,5114,22990,4.49550254204145
"5115",2006-01-21,6,5,-121.4216371,38.5074393,5115,22995,4.49560117302053
"5116",2006-01-21,3,4,-121.4257169,38.55981942,5116,22999,4.49550430023456
"5117",2006-01-21,3,6,-121.4367882,38.55949214,5117,23005,4.49579831932773
"5118",2006-01-21,1,3,-121.500518,38.63387829,5118,23008,4.49550605705354
"5119",2006-01-21,3,5,-121.4061503,38.55137298,5119,23013,4.49560461027544
"5120",2006-01-21,2,7,-121.4561435,38.64598304,5120,23020,4.49609375
"5121",2006-01-21,5,5,-121.4176675,38.45768744,5121,23025,4.49619214997071
"5122",2006-01-21,3,3,-121.5046032,38.58203886,5122,23028,4.49590003904725
"5123",2006-01-21,6,6,-121.4275429,38.53230306,5123,23034,4.49619363654109
"5124",2006-01-21,1,7,-121.4737527,38.6226827,5124,23041,4.49668227946916
"5125",2006-01-21,4,5,-121.4709983,38.52545833,5125,23046,4.49678048780488
"5126",2006-01-21,1,7,-121.5052301,38.62379897,5126,23053,4.49726882559501
"5127",2006-01-21,3,6,-121.3860079,38.56365214,5127,23059,4.49756192705286
"5128",2006-01-21,5,1,-121.4176675,38.45768744,5128,23060,4.49687987519501
"5129",2006-01-21,4,7,-121.4923709,38.56023256,5129,23067,4.49736790797426
"5130",2006-01-21,6,6,-121.4668149,38.5370682,5130,23073,4.49766081871345
"5131",2006-01-21,3,2,-121.4664482,38.57676186,5131,23075,4.49717404014812
"5132",2006-01-21,6,8,-121.4121873,38.50534592,5132,23083,4.49785658612627
"5133",2006-01-21,4,3,-121.4776224,38.53405028,5133,23086,4.49756477693357
"5134",2006-01-21,1,4,-121.5100674,38.63656065,5134,23090,4.49746786131671
"5135",2006-01-21,2,4,-121.4228743,38.6427604,5135,23094,4.49737098344693
"5136",2006-01-21,4,4,-121.4773762,38.54189707,5136,23098,4.49727414330218
"5137",2006-01-22,6,5,-121.4278799,38.54826969,5137,23103,4.49737200700798
"5138",2006-01-22,6,5,-121.4574761,38.54590243,5138,23108,4.4974698326197
"5139",2006-01-22,3,7,-121.4135687,38.5732988,5139,23115,4.49795680093403
"5140",2006-01-22,6,7,-121.4410246,38.5410297,5140,23122,4.49844357976654
"5141",2006-01-22,3,1,-121.4780915,38.57891009,5141,23123,4.49776308111262
"5142",2006-01-22,3,4,-121.4786515,38.56737967,5142,23127,4.49766627771295
"5143",2006-01-22,3,5,-121.4868954,38.58535847,5143,23132,4.49776395100136
"5144",2006-01-22,6,5,-121.4351262,38.5149777,5144,23137,4.49786158631415
"5145",2006-01-22,1,7,-121.4835074,38.61842097,5145,23144,4.49834791059281
"5146",2006-01-22,4,4,-121.4875413,38.55924745,5146,23148,4.49825106879129
"5147",2006-01-22,3,7,-121.4550798,38.57306779,5147,23155,4.49873712842432
"5148",2006-01-22,1,5,-121.5436137,38.65568296,5148,23160,4.4988344988345
"5149",2006-01-22,4,7,-121.5276299,38.51427486,5149,23167,4.49932025636046
"5150",2006-01-22,4,7,-121.4820839,38.54504586,5150,23174,4.49980582524272
"5151",2006-01-22,3,7,-121.4795213,38.58047622,5151,23181,4.50029120559115
"5152",2006-01-22,4,5,-121.5199373,38.53249542,5152,23186,4.50038819875776
"5153",2006-01-22,3,7,-121.4277708,38.55402191,5153,23193,4.50087327770231
"5154",2006-01-22,3,3,-121.4709815,38.58198348,5154,23196,4.50058207217695
"5155",2006-01-22,3,3,-121.4954827,38.57221296,5155,23199,4.50029097963143
"5156",2006-01-22,1,4,-121.5262517,38.60873755,5156,23203,4.50019394879752
"5157",2006-01-22,5,6,-121.4917258,38.48927466,5157,23209,4.50048477797169
"5158",2006-01-22,6,5,-121.4163888,38.52145848,5158,23214,4.50058162078325
"5159",2006-01-22,5,6,-121.4917258,38.48927466,5159,23220,4.50087226206629
"5160",2006-01-22,3,4,-121.5005108,38.56746233,5160,23224,4.50077519379845
"5161",2006-01-22,3,7,-121.4066144,38.56914993,5161,23231,4.50125944584383
"5162",2006-01-22,2,7,-121.4308265,38.60058081,5162,23238,4.50174351026734
"5163",2006-01-22,1,5,-121.4737513,38.6252419,5163,23243,4.50184001549487
"5164",2006-01-22,6,3,-121.4676206,38.55700746,5164,23246,4.50154918667699
"5165",2006-01-22,1,3,-121.4934617,38.61989556,5165,23249,4.50125847047435
"5166",2006-01-22,3,3,-121.4621644,38.57195861,5166,23252,4.50096786682152
"5167",2006-01-22,5,5,-121.4778443,38.49225256,5167,23257,4.501064447455
"5168",2006-01-22,1,5,-121.4943818,38.6698014,5168,23262,4.50116099071207
"5169",2006-01-22,6,7,-121.4331601,38.51698361,5169,23269,4.50164441864964
"5170",2006-01-22,2,1,-121.4515682,38.62445802,5170,23270,4.50096711798839
"5171",2006-01-22,2,3,-121.4642874,38.62275189,5171,23273,4.50067685167279
"5172",2006-01-22,5,6,-121.4747775,38.48500037,5172,23279,4.50096674400619
"5173",2006-01-22,1,3,-121.4948736,38.60933262,5173,23282,4.50067658998647
"5174",2006-01-22,4,5,-121.4758443,38.55720151,5174,23287,4.50077309625048
"5175",2006-01-22,4,4,-121.47576,38.54106323,5175,23291,4.50067632850242
"5176",2006-01-22,3,8,-121.4545409,38.57950174,5176,23299,4.50135239567233
"5177",2006-01-22,2,2,-121.4472415,38.61138598,5177,23301,4.50086922928337
"5178",2006-01-22,6,5,-121.4664168,38.5393455,5178,23306,4.50096562379297
"5179",2006-01-22,4,4,-121.5164382,38.47620565,5179,23310,4.5008688936088
"5180",2006-01-22,5,5,-121.4292813,38.47927911,5180,23315,4.50096525096525
"5181",2006-01-22,3,3,-121.5008344,38.58370044,5181,23318,4.50067554526153
"5182",2006-01-22,2,8,-121.4326056,38.59818409,5182,23326,4.50135082979545
"5183",2006-01-22,3,8,-121.4656229,38.57253205,5183,23334,4.50202585375265
"5184",2006-01-22,1,7,-121.4988152,38.61266409,5184,23341,4.50250771604938
"5185",2006-01-22,6,6,-121.4398269,38.51721654,5185,23347,4.50279652844744
"5186",2006-01-22,1,5,-121.5095521,38.66259811,5186,23352,4.50289240262244
"5187",2006-01-22,1,1,-121.5050821,38.61284481,5187,23353,4.50221708116445
"5188",2006-01-22,6,2,-121.4703152,38.54120868,5188,23355,4.50173477255204
"5189",2006-01-22,6,6,-121.4694958,38.53337899,5189,23361,4.50202351127385
"5190",2006-01-22,2,5,-121.4059613,38.63751254,5190,23366,4.50211946050096
"5191",2006-01-22,2,5,-121.4573294,38.6231314,5191,23371,4.50221537276055
"5192",2006-01-22,3,5,-121.4687391,38.57492438,5192,23376,4.50231124807396
"5193",2006-01-22,6,7,-121.4672524,38.52903833,5193,23383,4.50279222029655
"5194",2006-01-22,3,8,-121.4848294,38.57642774,5194,23391,4.50346553715826
"5195",2006-01-22,3,3,-121.4858505,38.58472227,5195,23394,4.50317613089509
"5196",2006-01-22,1,7,-121.5218778,38.60969712,5196,23401,4.50365665896844
"5197",2006-01-22,3,5,-121.4788,38.57578291,5197,23406,4.50375216471041
"5198",2006-01-22,4,6,-121.479014,38.53881527,5198,23412,4.50404001539053
"5199",2006-01-22,1,4,-121.4745819,38.64316291,5199,23416,4.50394306597423
"5200",2006-01-22,4,7,-121.5155975,38.52961332,5200,23423,4.50442307692308
"5201",2006-01-22,2,9,-121.4546163,38.64742572,5201,23432,4.50528744472217
"5202",2006-01-22,6,4,-121.4552803,38.54726509,5202,23436,4.50519031141869
"5203",2006-01-22,1,4,-121.4981332,38.68221008,5203,23440,4.50509321545262
"5204",2006-01-22,3,5,-121.4828556,38.56641822,5204,23445,4.50518831667948
"5205",2006-01-22,5,3,-121.479896,38.48111328,5205,23448,4.50489913544669
"5206",2006-01-22,6,7,-121.4449316,38.51114789,5206,23455,4.50537840952747
"5207",2006-01-22,6,6,-121.4698297,38.55055914,5207,23461,4.50566545035529
"5208",2006-01-22,1,5,-121.4947013,38.60993872,5208,23466,4.50576036866359
"5209",2006-01-22,4,8,-121.5443344,38.49587823,5209,23474,4.50643117680937
"5210",2006-01-22,4,2,-121.4743742,38.54029357,5210,23476,4.50595009596929
"5211",2006-01-22,5,5,-121.4572928,38.47343882,5211,23481,4.50604490500864
"5212",2006-01-22,4,7,-121.4754064,38.50878308,5212,23488,4.50652340752111
"5213",2006-01-22,2,7,-121.4401384,38.65623705,5213,23495,4.5070017264531
"5214",2006-01-22,2,1,-121.425595,38.64317482,5214,23496,4.50632911392405
"5215",2006-01-22,1,4,-121.4893334,38.62011633,5215,23500,4.50623202301055
"5216",2006-01-22,2,7,-121.4352821,38.60088271,5216,23507,4.50671012269939
"5217",2006-01-22,4,7,-121.5182564,38.52049693,5217,23514,4.50718803910293
"5218",2006-01-22,5,8,-121.428371,38.45814178,5218,23522,4.50785741663473
"5219",2006-01-22,4,5,-121.4957557,38.53555587,5219,23527,4.50795171488791
"5220",2006-01-22,1,1,-121.5055312,38.63589608,5220,23528,4.50727969348659
"5221",2006-01-22,1,4,-121.4735004,38.60803197,5221,23532,4.50718253208198
"5222",2006-01-22,3,8,-121.4067455,38.5676925,5222,23540,4.50785139793183
"5223",2006-01-22,3,7,-121.417918,38.56412181,5223,23547,4.50832854681218
"5224",2006-01-22,2,5,-121.4358495,38.60921393,5224,23552,4.50842266462481
"5225",2006-01-22,2,4,-121.4259204,38.63015516,5225,23556,4.50832535885167
"5226",2006-01-22,1,7,-121.5129034,38.64420903,5226,23563,4.5088021431305
"5227",2006-01-22,1,7,-121.5383574,38.62757407,5227,23570,4.509278744978
"5228",2006-01-22,4,8,-121.4739615,38.53366299,5228,23578,4.50994644223412
"5229",2006-01-22,2,7,-121.448687,38.63445879,5229,23585,4.51042264295276
"5230",2006-01-22,5,1,-121.5029365,38.48285946,5230,23586,4.50975143403442
"5231",2006-01-22,4,5,-121.4787921,38.51030591,5231,23591,4.50984515389027
"5232",2006-01-22,6,3,-121.4158942,38.51911369,5232,23594,4.50955657492355
"5233",2006-01-22,4,1,-121.4966878,38.5357494,5233,23595,4.5088859163004
"5234",2006-01-22,1,5,-121.4978558,38.61273956,5234,23600,4.50897974780283
"5235",2006-01-22,4,5,-121.4785789,38.55913053,5235,23605,4.5090735434575
"5236",2006-01-22,4,3,-121.4886957,38.5235828,5236,23608,4.50878533231474
"5237",2006-01-22,3,6,-121.4905456,38.57097214,5237,23614,4.5090700782891
"5238",2006-01-22,5,3,-121.4881693,38.49071157,5238,23617,4.50878197785414
"5239",2006-01-22,5,3,-121.4347565,38.4702938,5239,23620,4.50849398740218
"5240",2006-01-22,2,1,-121.4377717,38.6597047,5240,23621,4.50782442748092
"5241",2006-01-22,3,6,-121.4018971,38.57110548,5241,23627,4.5081091394772
"5242",2006-01-22,1,6,-121.5385043,38.67841269,5242,23633,4.50839374284624
"5243",2006-01-22,1,6,-121.5385043,38.67841269,5243,23639,4.5086782376502
"5244",2006-01-22,1,6,-121.5385043,38.67841269,5244,23645,4.50896262395118
"5245",2006-01-22,1,6,-121.5385043,38.67841269,5245,23651,4.50924690181125
"5246",2006-01-22,5,6,-121.4252618,38.46002107,5246,23657,4.50953107129241
"5247",2006-01-22,5,4,-121.4898585,38.4816794,5247,23661,4.50943396226415
"5248",2006-01-22,6,5,-121.4370014,38.55197203,5248,23666,4.50952743902439
"5249",2006-01-22,6,7,-121.4456482,38.52823386,5249,23673,4.51000190512479
"5250",2006-01-22,2,3,-121.4529572,38.63548679,5250,23676,4.50971428571429
"5251",2006-01-22,2,5,-121.4537502,38.63570472,5251,23681,4.50980765568463
"5252",2006-01-22,1,5,-121.497905,38.62911104,5252,23686,4.50990099009901
"5253",2006-01-22,4,6,-121.4965275,38.52676399,5253,23692,4.51018465638683
"5254",2006-01-22,5,3,-121.4859152,38.49079493,5254,23695,4.50989722116483
"5255",2006-01-22,2,4,-121.4461521,38.6268322,5255,23699,4.50980019029496
"5256",2006-01-22,6,5,-121.4666597,38.54146374,5256,23704,4.50989345509893
"5257",2006-01-22,2,5,-121.4293772,38.60546971,5257,23709,4.50998668442077
"5258",2006-01-22,3,3,-121.4759366,38.57463591,5258,23712,4.5096995055154
"5259",2006-01-22,6,4,-121.4340596,38.5234355,5259,23716,4.50960258604297
"5260",2006-01-22,5,1,-121.4564107,38.48746096,5260,23717,4.50893536121673
"5261",2006-01-22,5,2,-121.4967571,38.48476586,5261,23719,4.50845846797187
"5262",2006-01-22,1,8,-121.483187,38.63026551,5262,23727,4.5091220068415
"5263",2006-01-22,6,9,-121.4557168,38.54047367,5263,23736,4.50997529925898
"5264",2006-01-22,4,1,-121.4960651,38.53085892,5264,23737,4.5093085106383
"5265",2006-01-22,5,6,-121.4356566,38.47883261,5265,23743,4.50959164292498
"5266",2006-01-22,3,2,-121.4661587,38.57057941,5266,23745,4.50911507785796
"5267",2006-01-22,6,5,-121.4525249,38.55684916,5267,23750,4.50920827795709
"5268",2006-01-22,2,5,-121.4423556,38.62350787,5268,23755,4.50930144267274
"5269",2006-01-22,3,1,-121.4974099,38.58314743,5269,23756,4.50863541468969
"5270",2006-01-22,3,3,-121.5046032,38.58203886,5270,23759,4.50834914611006
"5271",2006-01-22,3,3,-121.4885667,38.57037029,5271,23762,4.50806298615064
"5272",2006-01-22,4,7,-121.4801105,38.52698794,5272,23769,4.50853566009105
"5273",2006-01-22,2,7,-121.4249294,38.59851693,5273,23776,4.50900815475062
"5274",2006-01-22,6,7,-121.4095681,38.52542198,5274,23783,4.50948047023132
"5275",2006-01-22,6,5,-121.4661397,38.55067948,5275,23788,4.50957345971564
"5276",2006-01-22,2,2,-121.4461937,38.61112011,5276,23790,4.50909780136467
"5277",2006-01-22,1,5,-121.4737527,38.6226827,5277,23795,4.50919082812204
"5278",2006-01-22,3,5,-121.4149051,38.55706875,5278,23800,4.50928381962865
"5279",2006-01-22,5,4,-121.4618223,38.49257451,5279,23804,4.50918734608827
"5280",2006-01-22,6,4,-121.4731603,38.54322621,5280,23808,4.50909090909091
"5281",2006-01-22,2,7,-121.4286169,38.5985901,5281,23815,4.50956258284416
"5282",2006-01-22,4,6,-121.4869834,38.50892288,5282,23821,4.50984475577433
"5283",2006-01-22,5,1,-121.460842,38.49515388,5283,23822,4.50918038992996
"5284",2006-01-22,3,7,-121.4747617,38.56791951,5284,23829,4.50965177895534
"5285",2006-01-22,2,4,-121.4576293,38.64444404,5285,23833,4.50955534531693
"5286",2006-01-22,3,8,-121.4818932,38.5857673,5286,23841,4.51021566401816
"5287",2006-01-22,6,1,-121.4715924,38.55806637,5287,23842,4.50955173066011
"5288",2006-01-22,5,4,-121.4465943,38.47427504,5288,23846,4.50945537065053
"5289",2006-01-22,1,4,-121.5195823,38.61744763,5289,23850,4.50935904707884
"5290",2006-01-22,2,5,-121.4210511,38.63143251,5290,23855,4.50945179584121
"5291",2006-01-22,2,5,-121.4229406,38.60948534,5291,23860,4.50954450954451
"5292",2006-01-22,3,5,-121.4411342,38.56722108,5292,23865,4.50963718820862
"5293",2006-01-22,2,2,-121.4457869,38.62743456,5293,23867,4.50916304553183
"5294",2006-01-22,3,5,-121.4135687,38.5732988,5294,23872,4.50925576123914
"5295",2006-01-22,5,4,-121.4445499,38.44879933,5295,23876,4.50915958451369
"5296",2006-01-22,5,2,-121.4567514,38.49043917,5296,23878,4.50868580060423
"5297",2006-01-22,4,5,-121.5014052,38.52655721,5297,23883,4.50877855389843
"5298",2006-01-22,4,5,-121.528845,38.49114533,5298,23888,4.50887127217818
"5299",2006-01-22,5,5,-121.4197563,38.46193495,5299,23893,4.50896395546329
"5300",2006-01-22,5,7,-121.4362357,38.47184425,5300,23900,4.50943396226415
"5301",2006-01-22,2,5,-121.4564308,38.60923272,5301,23905,4.50952650443313
"5302",2006-01-22,2,6,-121.4516527,38.60527526,5302,23911,4.50980761976613
"5303",2006-01-22,5,3,-121.4530858,38.48230213,5303,23914,4.5095229115595
"5304",2006-01-22,2,7,-121.4249294,38.59851693,5304,23921,4.50999245852187
"5305",2006-01-22,3,4,-121.4770995,38.57011311,5305,23925,4.50989632422243
"5306",2006-01-22,3,7,-121.4657874,38.56924317,5306,23932,4.51036562382209
"5307",2006-01-22,6,7,-121.4467668,38.54672494,5307,23939,4.51083474656115
"5308",2006-01-22,2,1,-121.4593596,38.61112465,5308,23940,4.51017332328561
"5309",2006-01-22,6,8,-121.4672009,38.54763911,5309,23948,4.51083066490865
"5310",2006-01-22,1,7,-121.5095521,38.66259811,5310,23955,4.51129943502825
"5311",2006-01-22,4,5,-121.5273701,38.49702385,5311,23960,4.51139145170401
"5312",2006-01-22,3,4,-121.4061503,38.55137298,5312,23964,4.51129518072289
"5313",2006-01-22,6,4,-121.461998,38.54438307,5313,23968,4.51119894598155
"5314",2006-01-22,6,7,-121.4250709,38.51759447,5314,23975,4.51166729394053
"5315",2006-01-22,1,4,-121.5069707,38.6191026,5315,23979,4.51157102539981
"5316",2006-01-22,2,3,-121.4473381,38.61112009,5316,23982,4.51128668171558
"5317",2006-01-22,3,4,-121.5017385,38.57145746,5317,23986,4.51119052097047
"5318",2006-01-22,2,5,-121.4572426,38.61062598,5318,23991,4.51128243700639
"5319",2006-01-22,3,5,-121.4790335,38.56440753,5319,23996,4.51137431848092
"5320",2006-01-22,1,5,-121.4769551,38.6308389,5320,24001,4.51146616541353
"5321",2006-01-22,1,5,-121.5252532,38.6625207,5321,24006,4.51155797782372
"5322",2006-01-22,6,2,-121.437393,38.51382995,5322,24008,4.51108605787298
"5323",2006-01-22,1,5,-121.4837565,38.62123941,5323,24013,4.51117790719519
"5324",2006-01-22,2,5,-121.4424124,38.64130735,5324,24018,4.51126972201352
"5325",2006-01-22,1,5,-121.5017595,38.61002422,5325,24023,4.51136150234742
"5326",2006-01-22,5,5,-121.442121,38.48440531,5326,24028,4.5114532482163
"5327",2006-01-22,4,7,-121.4986703,38.5262653,5327,24035,4.51192040548151
"5328",2006-01-22,1,4,-121.5297758,38.63528307,5328,24039,4.51182432432432
"5329",2006-01-22,2,5,-121.42747,38.60154457,5329,24044,4.5119159316945
"5330",2006-01-22,4,3,-121.47576,38.54106323,5330,24047,4.51163227016886
"5331",2006-01-22,5,5,-121.42717,38.47421612,5331,24052,4.51172387919715
"5332",2006-01-22,3,7,-121.4777082,38.57488007,5332,24059,4.51219054763691
"5333",2006-01-22,2,5,-121.4211494,38.61372713,5333,24064,4.5122820176261
"5334",2006-01-22,4,7,-121.4772381,38.53640731,5334,24071,4.51274840644919
"5335",2006-01-22,5,1,-121.4178456,38.44697363,5335,24072,4.51208997188379
"5336",2006-01-22,2,4,-121.4296009,38.63393529,5336,24076,4.5119940029985
"5337",2006-01-22,3,3,-121.4670118,38.57203045,5337,24079,4.51171069889451
"5338",2006-01-22,6,1,-121.4705253,38.53362535,5338,24080,4.51105282877482
"5339",2006-01-22,1,5,-121.4935963,38.61228167,5339,24085,4.51114440906537
"5340",2006-01-22,6,2,-121.4425904,38.52497346,5340,24087,4.51067415730337
"5341",2006-01-23,1,5,-121.5038482,38.61766139,5341,24092,4.51076577419959
"5342",2006-01-23,5,5,-121.4352353,38.47334964,5342,24097,4.51085735679521
"5343",2006-01-23,4,4,-121.5255605,38.51538948,5343,24101,4.51076174433839
"5344",2006-01-23,4,4,-121.5183764,38.52394358,5344,24105,4.51066616766467
"5345",2006-01-23,3,7,-121.4467727,38.58294949,5345,24112,4.511131898971
"5346",2006-01-23,3,4,-121.46491,38.57664767,5346,24116,4.51103628881407
"5347",2006-01-23,3,7,-121.4380753,38.55636527,5347,24123,4.51150177669721
"5348",2006-01-23,4,4,-121.5080805,38.50442058,5348,24127,4.51140613313388
"5349",2006-01-23,2,7,-121.4497795,38.60313827,5349,24134,4.51187137782763
"5350",2006-01-23,3,7,-121.4439212,38.56683909,5350,24141,4.51233644859813
"5351",2006-01-23,6,2,-121.4214978,38.52506487,5351,24143,4.51186694075874
"5352",2006-01-23,4,7,-121.4935943,38.53124355,5352,24150,4.51233183856502
"5353",2006-01-23,4,5,-121.5076416,38.52702876,5353,24155,4.51242294040725
"5354",2006-01-23,1,4,-121.4984478,38.6270814,5354,24159,4.51232723197609
"5355",2006-01-23,4,7,-121.512945,38.52796835,5355,24166,4.51279178338002
"5356",2006-01-23,4,7,-121.5349062,38.49928135,5356,24173,4.51325616131441
"5357",2006-01-23,4,1,-121.522261,38.52324849,5357,24174,4.51260033600896
"5358",2006-01-23,3,5,-121.4654979,38.57894325,5358,24179,4.5126913027249
"5359",2006-01-23,2,3,-121.4303283,38.63228581,5359,24182,4.51240903153573
"5360",2006-01-23,6,5,-121.4457601,38.54082732,5360,24187,4.5125
"5361",2006-01-23,5,5,-121.4195068,38.46383938,5361,24192,4.51259093452714
"5362",2006-01-23,3,1,-121.4671338,38.56833498,5362,24193,4.51193584483402
"5363",2006-01-23,6,5,-121.4431889,38.52532233,5363,24198,4.5120268506433
"5364",2006-01-23,2,1,-121.4618088,38.61214382,5364,24199,4.5113721103654
"5365",2006-01-23,6,3,-121.4184906,38.50673978,5365,24202,4.51109040074557
"5366",2006-01-23,2,2,-121.4461937,38.61112011,5366,24204,4.51062243756988
"5367",2006-01-23,3,1,-121.4852125,38.57810996,5367,24205,4.50996832494876
"5368",2006-01-23,3,7,-121.4896385,38.56723092,5368,24212,4.51043219076006
"5369",2006-01-23,3,3,-121.4879409,38.56837397,5369,24215,4.51015086608307
"5370",2006-01-23,6,7,-121.4103481,38.52578019,5370,24222,4.51061452513966
"5371",2006-01-23,6,4,-121.4566539,38.54871866,5371,24226,4.5105194563396
"5372",2006-01-23,2,8,-121.4567993,38.60955023,5372,24234,4.51116902457185
"5373",2006-01-23,6,1,-121.4663645,38.54119328,5373,24235,4.51051554066629
"5374",2006-01-23,6,5,-121.4502184,38.54031312,5374,24240,4.51060662448828
"5375",2006-01-23,6,9,-121.4383522,38.51585289,5375,24249,4.51144186046512
"5376",2006-01-23,4,1,-121.5060656,38.49563049,5376,24250,4.51078869047619
"5377",2006-01-23,3,5,-121.4722695,38.57432818,5377,24255,4.51087967267993
"5378",2006-01-23,1,8,-121.4760509,38.62717997,5378,24263,4.51152844923763
"5379",2006-01-23,5,5,-121.4875664,38.47979104,5379,24268,4.51161926008552
"5380",2006-01-23,2,7,-121.4457338,38.63651514,5380,24275,4.51208178438662
"5381",2006-01-23,4,7,-121.4939831,38.533107,5381,24282,4.51254413677755
"5382",2006-01-23,3,1,-121.4996207,38.58316799,5382,24283,4.51189149015236
"5383",2006-01-23,3,5,-121.5049307,38.57316266,5383,24288,4.5119821660784
"5384",2006-01-23,4,7,-121.5445064,38.48973627,5384,24295,4.51244427934621
"5385",2006-01-23,3,7,-121.4662476,38.57879568,5385,24302,4.51290622098422
"5386",2006-01-23,3,1,-121.4926811,38.5923559,5386,24303,4.51225399183067
"5387",2006-01-23,4,7,-121.476938,38.53966813,5387,24310,4.51271579728977
"5388",2006-01-23,4,5,-121.5033469,38.5288337,5388,24315,4.51280623608018
"5389",2006-01-23,3,9,-121.493943,38.57920289,5389,24324,4.51363889404342
"5390",2006-01-23,4,5,-121.500048,38.54016571,5390,24329,4.51372912801484
"5391",2006-01-23,6,2,-121.4351262,38.5149777,5391,24331,4.51326284548321
"5392",2006-01-23,5,5,-121.4815172,38.49502052,5392,24336,4.513353115727
"5393",2006-01-23,6,7,-121.4529838,38.52982848,5393,24343,4.51381420359726
"5394",2006-01-23,3,5,-121.415297,38.57411211,5394,24348,4.5139043381535
"5395",2006-01-23,2,4,-121.4329623,38.60086039,5395,24352,4.51380908248378
"5396",2006-01-23,5,5,-121.4267582,38.44849277,5396,24357,4.51389918458117
"5397",2006-01-23,3,4,-121.4097872,38.57248051,5397,24361,4.51380396516583
"5398",2006-01-23,2,1,-121.4296482,38.66476972,5398,24362,4.5131530196369
"5399",2006-01-23,3,1,-121.4987178,38.58171423,5399,24363,4.51250231524356
"5400",2006-01-23,6,4,-121.4704591,38.55385441,5400,24367,4.51240740740741
"5401",2006-01-23,2,6,-121.3815598,38.63862878,5401,24373,4.51268283651176
"5402",2006-01-23,4,7,-121.5545331,38.49819435,5402,24380,4.51314328026657
"5403",2006-01-23,6,4,-121.469478,38.5527076,5403,24384,4.51304830649639
"5404",2006-01-23,1,2,-121.4937441,38.62744262,5404,24386,4.51258327165063
"5405",2006-01-23,3,1,-121.4934629,38.58031289,5405,24387,4.51193339500463
"5406",2006-01-23,3,1,-121.4921151,38.57995276,5406,24388,4.51128375878653
"5407",2006-01-23,3,2,-121.4714677,38.56452151,5407,24390,4.51081930830405
"5408",2006-01-23,2,6,-121.4510275,38.66239611,5408,24396,4.51109467455621
"5409",2006-01-23,3,3,-121.4550616,38.56446191,5409,24399,4.5108153078203
"5410",2006-01-23,2,7,-121.4420929,38.61547198,5410,24406,4.51127541589649
"5411",2006-01-23,4,2,-121.4778666,38.5580262,5411,24408,4.51081131029385
"5412",2006-01-23,3,5,-121.4965114,38.58355816,5412,24413,4.51090169992609
"5413",2006-01-23,5,1,-121.4294795,38.45051901,5413,24414,4.51025309440236
"5414",2006-01-23,6,1,-121.4316473,38.51690753,5414,24415,4.50960472848171
"5415",2006-01-23,3,5,-121.4801454,38.58075911,5415,24420,4.50969529085873
"5416",2006-01-23,1,7,-121.4979744,38.61975319,5416,24427,4.51015509601182
"5417",2006-01-23,5,3,-121.4630104,38.48093723,5417,24430,4.50987631530367
"5418",2006-01-23,1,7,-121.5000769,38.61890556,5418,24437,4.51033591731266
"5419",2006-01-23,3,5,-121.4278339,38.55443686,5419,24442,4.51042627791105
"5420",2006-01-23,3,1,-121.4987842,38.58173099,5420,24443,4.50977859778598
"5421",2006-01-23,4,1,-121.4809433,38.49850804,5421,24444,4.50913115661317
"5422",2006-01-23,6,4,-121.4526562,38.54611863,5422,24448,4.50903725562523
"5423",2006-01-23,3,7,-121.4986248,38.58052209,5423,24455,4.50949658860409
"5424",2006-01-23,4,4,-121.4754446,38.55591735,5424,24459,4.50940265486726
"5425",2006-01-23,1,5,-121.4954943,38.61013165,5425,24464,4.5094930875576
"5426",2006-01-23,3,1,-121.495181,38.58320363,5426,24465,4.50884629561371
"5427",2006-01-23,5,4,-121.4167524,38.46154638,5427,24469,4.50875253362816
"5428",2006-01-23,4,7,-121.4737197,38.49580633,5428,24476,4.50921149594694
"5429",2006-01-23,6,1,-121.4234424,38.54656989,5429,24477,4.50856511328053
"5430",2006-01-23,6,8,-121.4402677,38.51181739,5430,24485,4.50920810313075
"5431",2006-01-23,3,3,-121.5020207,38.57763429,5431,24488,4.50893021542994
"5432",2006-01-23,3,1,-121.5000936,38.58207989,5432,24489,4.50828424153166
"5433",2006-01-23,2,9,-121.4369555,38.61364029,5433,24498,4.5091109884042
"5434",2006-01-23,6,6,-121.4564089,38.55196871,5434,24504,4.50938535149061
"5435",2006-01-23,5,7,-121.4370847,38.45186063,5435,24511,4.50984360625575
"5436",2006-01-23,5,6,-121.4776557,38.47504015,5436,24517,4.51011773362767
"5437",2006-01-23,6,1,-121.4234424,38.54656989,5437,24518,4.50947213536877
"5438",2006-01-23,5,1,-121.441739,38.47427092,5438,24519,4.50882677454947
"5439",2006-01-23,3,1,-121.4907988,38.57960099,5439,24520,4.50818165103879
"5440",2006-01-23,5,1,-121.4267274,38.44971731,5440,24521,4.50753676470588
"5441",2006-01-23,4,5,-121.4762318,38.50773512,5441,24526,4.50762727439809
"5442",2006-01-23,5,7,-121.428879,38.45400615,5442,24533,4.50808526277104
"5443",2006-01-23,5,4,-121.4859396,38.48934244,5443,24537,4.50799191622267
"5444",2006-01-23,1,4,-121.4959999,38.63020663,5444,24541,4.50789860396767
"5445",2006-01-23,4,5,-121.4762318,38.50773512,5445,24546,4.50798898071625
"5446",2006-01-23,5,6,-121.428879,38.45400615,5446,24552,4.50826294528094
"5447",2006-01-23,3,4,-121.4840508,38.57138272,5447,24556,4.50816963466128
"5448",2006-01-23,2,5,-121.4441654,38.63650214,5448,24561,4.50825991189427
"5449",2006-01-23,1,2,-121.5018592,38.65837227,5449,24563,4.50779959625619
"5450",2006-01-23,1,4,-121.5160097,38.6075117,5450,24567,4.50770642201835
"5451",2006-01-23,2,7,-121.420306,38.61414579,5451,24574,4.50816363969914
"5452",2006-01-23,4,9,-121.4680072,38.52343733,5452,24583,4.50898752751284
"5453",2006-01-23,3,1,-121.5000936,38.58207989,5453,24584,4.50834403080873
"5454",2006-01-23,2,6,-121.4478931,38.6144673,5454,24590,4.50861752841951
"5455",2006-01-23,2,3,-121.4303283,38.63228581,5455,24593,4.5083409715857
"5456",2006-01-23,6,1,-121.4676269,38.54116339,5456,24594,4.50769794721408
"5457",2006-01-23,2,6,-121.4200407,38.62783576,5457,24600,4.50797141286421
"5458",2006-01-23,3,6,-121.4765457,38.57360894,5458,24606,4.50824477830707
"5459",2006-01-23,5,7,-121.4321661,38.46222175,5459,24613,4.50870122733101
"5460",2006-01-23,2,7,-121.4618534,38.60343939,5460,24620,4.50915750915751
"5461",2006-01-23,6,1,-121.4063559,38.51194212,5461,24621,4.50851492400659
"5462",2006-01-23,3,1,-121.4974538,38.58137649,5462,24622,4.50787257414866
"5463",2006-01-23,6,3,-121.4101636,38.53499467,5463,24625,4.5075965586674
"5464",2006-01-23,2,1,-121.4237902,38.6186885,5464,24626,4.50695461200586
"5465",2006-01-23,6,5,-121.4629553,38.55610171,5465,24631,4.50704483074108
"5466",2006-01-23,6,5,-121.4712461,38.54392319,5466,24636,4.50713501646542
"5467",2006-01-23,6,7,-121.4411123,38.55260155,5467,24643,4.50759100054875
"5468",2006-01-23,2,1,-121.4212584,38.62142182,5468,24644,4.50694952450622
"5469",2006-01-23,6,6,-121.4402677,38.51181739,5469,24650,4.5072225269702
"5470",2006-01-23,2,7,-121.4412574,38.61982027,5470,24657,4.50767824497258
"5471",2006-01-23,3,8,-121.4825623,38.58129991,5471,24665,4.50831657832206
"5472",2006-01-23,1,4,-121.5022266,38.67696928,5472,24669,4.50822368421053
"5473",2006-01-23,3,1,-121.4790738,38.56654955,5473,24670,4.50758267860406
"5474",2006-01-23,4,5,-121.5081919,38.52477943,5474,24675,4.5076726342711
"5475",2006-01-23,5,1,-121.4281322,38.45700378,5475,24676,4.50703196347032
"5476",2006-01-23,5,6,-121.4472502,38.48115128,5476,24682,4.5073046018992
"5477",2006-01-23,5,1,-121.4472502,38.48115128,5477,24683,4.50666423224393
"5478",2006-01-23,3,4,-121.4979339,38.58026647,5478,24687,4.5065717415115
"5479",2006-01-23,4,5,-121.4908853,38.5488551,5479,24692,4.50666179959847
"5480",2006-01-23,6,1,-121.4715398,38.55477924,5480,24693,4.50602189781022
"5481",2006-01-23,6,4,-121.467166,38.54436304,5481,24697,4.50592957489509
"5482",2006-01-23,2,1,-121.4258271,38.6017616,5482,24698,4.50529004013134
"5483",2006-01-23,3,4,-121.4852542,38.56796664,5483,24702,4.50519788436987
"5484",2006-01-23,3,7,-121.4907939,38.58029569,5484,24709,4.50565280816922
"5485",2006-01-23,3,4,-121.5014996,38.58062786,5485,24713,4.50556061987238
"5486",2006-01-23,3,4,-121.418725,38.57495865,5486,24717,4.50546846518411
"5487",2006-01-23,5,6,-121.4859396,38.48934244,5487,24723,4.50574084199016
"5488",2006-01-23,6,1,-121.4633315,38.54700614,5488,24724,4.50510204081633
"5489",2006-01-23,4,9,-121.4990149,38.52199137,5489,24733,4.50592093277464
"5490",2006-01-23,5,5,-121.4171002,38.4600104,5490,24738,4.50601092896175
"5491",2006-01-23,3,1,-121.4789523,38.57887553,5491,24739,4.50537242760881
"5492",2006-01-23,5,5,-121.4960425,38.48849997,5492,24744,4.50546249089585
"5493",2006-01-23,2,2,-121.4347279,38.64740181,5493,24746,4.50500637174586
"5494",2006-01-23,1,5,-121.4947615,38.61428854,5494,24751,4.50509646887514
"5495",2006-01-23,2,5,-121.4573227,38.6111316,5495,24756,4.50518653321201
"5496",2006-01-23,2,1,-121.4384169,38.65470747,5496,24757,4.50454876273654
"5497",2006-01-23,4,3,-121.4790449,38.55805348,5497,24760,4.50427505912316
"5498",2006-01-23,3,7,-121.493943,38.57920289,5498,24767,4.50472899236086
"5499",2006-01-23,6,6,-121.4402677,38.51181739,5499,24773,4.50500090925623
"5500",2006-01-23,5,3,-121.42717,38.47421612,5500,24776,4.50472727272727
"5501",2006-01-23,4,1,-121.5212433,38.49466185,5501,24777,4.50409016542447
"5502",2006-01-23,4,4,-121.47238,38.49742308,5502,24781,4.50399854598328
"5503",2006-01-23,6,3,-121.4458932,38.53584406,5503,24784,4.50372524077776
"5504",2006-01-23,1,3,-121.5433421,38.65981725,5504,24787,4.50345203488372
"5505",2006-01-23,1,7,-121.5210466,38.67560969,5505,24794,4.5039055404178
"5506",2006-01-23,5,4,-121.4722254,38.48005429,5506,24798,4.50381402106793
"5507",2006-01-23,4,2,-121.4728534,38.53364422,5507,24800,4.50335936081351
"5508",2006-01-23,6,7,-121.4177433,38.50795522,5508,24807,4.50381263616558
"5509",2006-01-23,6,5,-121.4214978,38.52506487,5509,24812,4.50390270466509
"5510",2006-01-23,5,7,-121.46994,38.47826995,5510,24819,4.5043557168784
"5511",2006-01-23,4,3,-121.4857011,38.55982692,5511,24822,4.5040827436037
"5512",2006-01-23,6,5,-121.4338435,38.53569785,5512,24827,4.50417271407837
"5513",2006-01-23,1,5,-121.499981,38.614108,5513,24832,4.50426265191366
"5514",2006-01-23,4,4,-121.481613,38.55403671,5514,24836,4.50417120058034
"5515",2006-01-23,2,1,-121.4258271,38.6017616,5515,24837,4.50353581142339
"5516",2006-01-23,2,5,-121.4487938,38.61929621,5516,24842,4.50362581580856
"5517",2006-01-23,2,7,-121.4388338,38.6115515,5517,24849,4.50407830342577
"5518",2006-01-23,6,2,-121.433748,38.51953747,5518,24851,4.50362450163103
"5519",2006-01-23,2,2,-121.4308978,38.63592424,5519,24853,4.50317086428701
"5520",2006-01-23,2,5,-121.4578717,38.61533547,5520,24858,4.50326086956522
"5521",2006-01-23,3,5,-121.4964249,38.57003953,5521,24863,4.50335084223873
"5522",2006-01-23,3,5,-121.5023171,38.56673694,5522,24868,4.50344078232524
"5523",2006-01-23,1,4,-121.4745819,38.64316291,5523,24872,4.50334962882491
"5524",2006-01-23,3,6,-121.495157,38.57918073,5524,24878,4.50362056480811
"5525",2006-01-23,6,1,-121.3907012,38.52149079,5525,24879,4.50298642533937
"5526",2006-01-23,3,5,-121.5061034,38.57504039,5526,24884,4.50307636626855
"5527",2006-01-23,2,4,-121.4258271,38.6017616,5527,24888,4.50298534467161
"5528",2006-01-23,1,7,-121.5165137,38.60388643,5528,24895,4.50343704775687
"5529",2006-01-23,4,3,-121.5373071,38.50084518,5529,24898,4.50316512931814
"5530",2006-01-23,2,4,-121.42747,38.60154457,5530,24902,4.50307414104882
"5531",2006-01-23,5,3,-121.42717,38.47421612,5531,24905,4.50280238654854
"5532",2006-01-23,1,7,-121.4932977,38.61292566,5532,24912,4.50325379609544
"5533",2006-01-23,2,4,-121.42747,38.60154457,5533,24916,4.50316284113501
"5534",2006-01-23,2,8,-121.4556376,38.60907522,5534,24924,4.50379472352729
"5535",2006-01-23,6,3,-121.4399243,38.52083892,5535,24927,4.50352303523035
"5536",2006-01-23,6,1,-121.409083,38.51055016,5536,24928,4.5028901734104
"5537",2006-01-23,6,7,-121.4128401,38.5236977,5537,24935,4.50334115947264
"5538",2006-01-23,5,5,-121.4992844,38.49252587,5538,24940,4.50343084145901
"5539",2006-01-23,2,1,-121.4252477,38.60027317,5539,24941,4.50279833905037
"5540",2006-01-23,5,1,-121.4372729,38.46388056,5540,24942,4.50216606498195
"5541",2006-01-23,5,6,-121.4326535,38.47385049,5541,24948,4.50243638332431
"5542",2006-01-23,5,2,-121.440484,38.46503572,5542,24950,4.50198484301696
"5543",2006-01-23,5,1,-121.4196575,38.47581524,5543,24951,4.50135305791088
"5544",2006-01-23,4,5,-121.49564,38.56281979,5544,24956,4.501443001443
"5545",2006-01-23,5,2,-121.4533502,38.48335233,5545,24958,4.5009918845807
"5546",2006-01-23,6,3,-121.435864,38.5105054,5546,24961,4.50072124053372
"5547",2006-01-23,3,5,-121.4734742,38.56180943,5547,24966,4.50081124932396
"5548",2006-01-23,6,6,-121.4351262,38.5149777,5548,24972,4.50108147080029
"5549",2006-01-23,2,2,-121.4494917,38.6154909,5549,24974,4.50063074427825
"5550",2006-01-23,6,5,-121.4566198,38.54676613,5550,24979,4.50072072072072
"5551",2006-01-23,4,5,-121.503927,38.55301417,5551,24984,4.50081066474509
"5552",2006-01-23,5,7,-121.4820179,38.48909428,5552,24991,4.50126080691643
"5553",2006-01-23,3,1,-121.4944921,38.58119335,5553,24992,4.50063028993337
"5554",2006-01-23,3,4,-121.475033,38.57003237,5554,24996,4.50054015124235
"5555",2006-01-23,2,1,-121.4192999,38.61992921,5555,24997,4.4999099909991
"5556",2006-01-23,6,3,-121.4249688,38.53591495,5556,25000,4.4996400287977
"5557",2006-01-23,2,5,-121.4177759,38.63425266,5557,25005,4.49973007018175
"5558",2006-01-23,2,5,-121.4172688,38.64018136,5558,25010,4.49982007916517
"5559",2006-01-23,2,7,-121.4509995,38.63829761,5559,25017,4.50026983270372
"5560",2006-01-23,2,7,-121.42747,38.60154457,5560,25024,4.50071942446043
"5561",2006-01-23,3,6,-121.4909396,38.58634838,5561,25030,4.50098903074987
"5562",2006-01-23,2,2,-121.4291369,38.65821813,5562,25032,4.50053937432578
"5563",2006-01-23,6,8,-121.4376713,38.53973934,5563,25040,4.50116843429804
"5564",2006-01-23,4,7,-121.5050613,38.56089163,5564,25047,4.50161754133717
"5565",2006-01-23,6,3,-121.4597405,38.55069371,5565,25050,4.50134770889488
"5566",2006-01-23,5,6,-121.4855643,38.49439879,5566,25056,4.50161696011498
"5567",2006-01-23,1,3,-121.528,38.63910642,5567,25059,4.50134722471708
"5568",2006-01-23,3,2,-121.4589599,38.57110342,5568,25061,4.50089798850575
"5569",2006-01-23,3,2,-121.4906124,38.58267837,5569,25063,4.50044891362902
"5570",2006-01-23,2,2,-121.420308,38.61260532,5570,25065,4.5
"5571",2006-01-23,3,1,-121.4618898,38.57357744,5571,25066,4.49937174654461
"5572",2006-01-23,5,2,-121.4892835,38.48586717,5572,25068,4.4989231873654
"5573",2006-01-23,6,3,-121.4149168,38.52663815,5573,25071,4.4986542257312
"5574",2006-01-23,5,5,-121.499208,38.47551721,5574,25076,4.49874416935773
"5575",2006-01-23,1,2,-121.4737527,38.6226827,5575,25078,4.49829596412556
"5576",2006-01-23,3,3,-121.4847093,38.57464509,5576,25081,4.49802725968436
"5577",2006-01-23,1,5,-121.4814479,38.6325808,5577,25086,4.49811726734804
"5578",2006-01-23,6,7,-121.4482404,38.54245379,5578,25093,4.49856579419147
"5579",2006-01-23,3,5,-121.3933213,38.54921677,5579,25098,4.49865567305969
"5580",2006-01-23,5,1,-121.4353493,38.44257636,5580,25099,4.49802867383513
"5581",2006-01-23,4,2,-121.4920604,38.52475641,5581,25101,4.49758107865974
"5582",2006-01-24,3,5,-121.4635138,38.56694254,5582,25106,4.49767108563239
"5583",2006-01-24,3,4,-121.4490974,38.55871113,5583,25110,4.49758194519076
"5584",2006-01-24,2,4,-121.4421748,38.65063142,5584,25114,4.49749283667622
"5585",2006-01-24,5,4,-121.4140666,38.44111939,5585,25118,4.49740376007162
"5586",2006-01-24,4,7,-121.5323458,38.51196547,5586,25125,4.49785177228786
"5587",2006-01-24,1,7,-121.5313839,38.63615455,5587,25132,4.49829962412744
"5588",2006-01-24,3,4,-121.4117998,38.5731745,5588,25136,4.49821045096636
"5589",2006-01-24,4,4,-121.4753422,38.5393973,5589,25140,4.49812130971551
"5590",2006-01-24,2,5,-121.4661498,38.65356442,5590,25145,4.49821109123435
"5591",2006-01-24,5,5,-121.4660122,38.50135899,5591,25150,4.49830084063674
"5592",2006-01-24,6,2,-121.4348555,38.50811974,5592,25152,4.49785407725322
"5593",2006-01-24,6,5,-121.4236517,38.51198841,5593,25157,4.49794385839442
"5594",2006-01-24,2,5,-121.4608872,38.60813046,5594,25162,4.49803360743654
"5595",2006-01-24,1,4,-121.5324218,38.6284372,5595,25166,4.49794459338695
"5596",2006-01-24,1,1,-121.4752323,38.61093405,5596,25167,4.49731951393853
"5597",2006-01-24,2,7,-121.4457338,38.63651514,5597,25174,4.4977666607111
"5598",2006-01-24,3,4,-121.4789156,38.57432259,5598,25178,4.49767774205073
"5599",2006-01-24,1,1,-121.5088355,38.63700302,5599,25179,4.49705304518664
"5600",2006-01-24,1,7,-121.4988152,38.61266409,5600,25186,4.4975
"5601",2006-01-24,3,3,-121.4886487,38.56674052,5601,25189,4.4972326370291
"5602",2006-01-24,6,7,-121.458959,38.5467716,5602,25196,4.49767940021421
"5603",2006-01-24,6,8,-121.4439429,38.55103901,5603,25204,4.49830447974299
"5604",2006-01-24,5,5,-121.428592,38.47199619,5604,25209,4.49839400428266
"5605",2006-01-24,6,3,-121.4120841,38.52084905,5605,25212,4.49812667261374
"5606",2006-01-24,3,3,-121.4665332,38.56446867,5606,25215,4.49785943631823
"5607",2006-01-24,1,9,-121.5121866,38.61490968,5607,25224,4.49866238630284
"5608",2006-01-24,6,2,-121.4461521,38.53266824,5608,25226,4.49821683309558
"5609",2006-01-24,1,5,-121.4922875,38.61569463,5609,25231,4.49830629345694
"5610",2006-01-24,1,5,-121.4747506,38.63262477,5610,25236,4.49839572192513
"5611",2006-01-24,3,3,-121.4848294,38.57642774,5611,25239,4.49812867581536
"5612",2006-01-24,1,7,-121.5231067,38.6593321,5612,25246,4.49857448325018
"5613",2006-01-24,6,1,-121.4111198,38.51613758,5613,25247,4.49795118474969
"5614",2006-01-24,1,9,-121.5298996,38.63136239,5614,25256,4.49875311720698
"5615",2006-01-24,5,6,-121.4362238,38.45387196,5615,25262,4.49902048085485
"5616",2006-01-24,6,7,-121.4609781,38.55119375,5616,25269,4.49946581196581
"5617",2006-01-24,6,4,-121.4433516,38.53046628,5617,25273,4.49937689157913
"5618",2006-01-24,3,7,-121.3848854,38.54983126,5618,25280,4.499822000712
"5619",2006-01-24,6,2,-121.4438954,38.52393354,5619,25282,4.49937711336537
"5620",2006-01-24,4,2,-121.5467908,38.49477029,5620,25284,4.49893238434164
"5621",2006-01-24,3,2,-121.4978798,38.59540732,5621,25286,4.49848781355631
"5622",2006-01-24,6,7,-121.4431606,38.54105373,5622,25293,4.49893276414087
"5623",2006-01-24,4,6,-121.5076046,38.49793266,5623,25299,4.49919971545438
"5624",2006-01-24,1,7,-121.5185481,38.61613902,5624,25306,4.49964438122333
"5625",2006-01-24,4,1,-121.4737305,38.53275029,5625,25307,4.49902222222222
"5626",2006-01-24,3,5,-121.4669217,38.57566567,5626,25312,4.49911126910771
"5627",2006-01-24,1,3,-121.5246636,38.67792841,5627,25315,4.49884485516261
"5628",2006-01-24,5,6,-121.4327124,38.461159,5628,25321,4.49911158493248
"5629",2006-01-24,3,3,-121.4976906,38.57905171,5629,25324,4.49884526558891
"5630",2006-01-24,2,5,-121.446116,38.62968232,5630,25329,4.49893428063943
"5631",2006-01-24,6,2,-121.4670223,38.53457035,5631,25331,4.49849049902326
"5632",2006-01-24,1,1,-121.5120524,38.65599922,5632,25332,4.49786931818182
"5633",2006-01-24,4,1,-121.4727965,38.52904451,5633,25333,4.497248357891
"5634",2006-01-24,4,1,-121.4755662,38.54031271,5634,25334,4.49662761803337
"5635",2006-01-24,6,1,-121.4178811,38.53306765,5635,25335,4.49600709849157
"5636",2006-01-24,6,7,-121.4177778,38.52258034,5636,25342,4.49645138396026
"5637",2006-01-24,6,7,-121.4124426,38.50022327,5637,25349,4.49689551179705
"5638",2006-01-24,5,4,-121.4605041,38.46448285,5638,25353,4.49680737850302
"5639",2006-01-24,6,5,-121.4509881,38.54751665,5639,25358,4.49689661287462
"5640",2006-01-24,4,8,-121.4960208,38.55199422,5640,25366,4.49751773049645
"5641",2006-01-24,2,5,-121.4584643,38.62901851,5641,25371,4.49760680730367
"5642",2006-01-24,6,1,-121.4160005,38.52790402,5642,25372,4.49698688408366
"5643",2006-01-24,3,8,-121.4827802,38.57005626,5643,25380,4.49760765550239
"5644",2006-01-24,2,6,-121.4300978,38.61382368,5644,25386,4.49787384833451
"5645",2006-01-24,2,6,-121.3815598,38.63862878,5645,25392,4.49813994685562
"5646",2006-01-24,4,1,-121.4750062,38.53802555,5646,25393,4.49752036840241
"5647",2006-01-24,5,1,-121.4786384,38.47392424,5647,25394,4.49690100938551
"5648",2006-01-24,4,1,-121.4746387,38.53855659,5648,25395,4.49628186968839
"5649",2006-01-24,2,3,-121.4413746,38.63523107,5649,25398,4.49601699415826
"5650",2006-01-24,4,1,-121.4709707,38.52164684,5650,25399,4.4953982300885
"5651",2006-01-24,2,5,-121.456597,38.62232615,5651,25404,4.49548752433198
"5652",2006-01-24,6,1,-121.4705253,38.53362535,5652,25405,4.49486907289455
"5653",2006-01-24,3,7,-121.4728985,38.57394387,5653,25412,4.49531222359809
"5654",2006-01-24,4,1,-121.4743108,38.53513366,5654,25413,4.49469402193138
"5655",2006-01-24,1,5,-121.49689,38.61022833,5655,25418,4.494783377542
"5656",2006-01-24,4,3,-121.4936866,38.542873,5656,25421,4.49451909476662
"5657",2006-01-24,5,7,-121.4573114,38.47237623,5657,25428,4.49496199398975
"5658",2006-01-24,5,7,-121.4218653,38.45896341,5658,25435,4.49540473665606
"5659",2006-01-24,5,7,-121.4065446,38.44466172,5659,25442,4.49584732284856
"5660",2006-01-24,2,3,-121.433145,38.62541828,5660,25445,4.49558303886926
"5661",2006-01-24,1,4,-121.5095127,38.65357208,5661,25449,4.4954954954955
"5662",2006-01-24,5,6,-121.4964589,38.47652401,5662,25455,4.49576121511833
"5663",2006-01-24,1,4,-121.5061432,38.61780575,5663,25459,4.49567367119901
"5664",2006-01-24,1,2,-121.4763493,38.63659439,5664,25461,4.49523305084746
"5665",2006-01-24,4,5,-121.5428213,38.4964544,5665,25466,4.49532215357458
"5666",2006-01-24,4,8,-121.4907499,38.54480973,5666,25474,4.49594069890575
"5667",2006-01-24,5,1,-121.4659839,38.47664262,5667,25475,4.49532380448209
"5668",2006-01-24,6,3,-121.4316473,38.51690753,5668,25478,4.49505998588567
"5669",2006-01-24,4,1,-121.4745855,38.53627722,5669,25479,4.49444346445581
"5670",2006-01-24,6,3,-121.4441455,38.52503037,5670,25482,4.49417989417989
"5671",2006-01-24,3,5,-121.4117998,38.5731745,5671,25487,4.49426908834421
"5672",2006-01-24,1,1,-121.5259712,38.64303305,5672,25488,4.49365303244006
"5673",2006-01-24,5,1,-121.428337,38.46413328,5673,25489,4.49303719372466
"5674",2006-01-24,5,1,-121.4657412,38.47779754,5674,25490,4.49242157208319
"5675",2006-01-24,4,6,-121.5076046,38.49793266,5675,25496,4.4926872246696
"5676",2006-01-24,3,5,-121.4770347,38.56607629,5676,25501,4.49277660324172
"5677",2006-01-24,4,7,-121.4972545,38.56201402,5677,25508,4.49321824907522
"5678",2006-01-24,1,1,-121.5050821,38.61284481,5678,25509,4.49260302923565
"5679",2006-01-24,4,1,-121.4711572,38.52241656,5679,25510,4.49198802606093
"5680",2006-01-24,2,2,-121.4584643,38.62901851,5680,25512,4.49154929577465
"5681",2006-01-24,3,6,-121.5011657,38.58184562,5681,25518,4.49181482133427
"5682",2006-01-24,3,2,-121.4840333,38.57621825,5682,25520,4.49137627595917
"5683",2006-01-24,2,5,-121.4375154,38.62473388,5683,25525,4.49146577511878
"5684",2006-01-24,1,1,-121.5349582,38.65121663,5684,25526,4.490851513019
"5685",2006-01-24,4,7,-121.4885401,38.53700426,5685,25533,4.49129287598945
"5686",2006-01-24,1,1,-121.502792,38.61653377,5686,25534,4.49067886035878
"5687",2006-01-24,1,7,-121.4948783,38.61211702,5687,25541,4.4911200984702
"5688",2006-01-24,5,7,-121.4673944,38.49407763,5688,25548,4.4915611814346
"5689",2006-01-24,4,1,-121.4717471,38.52488785,5689,25549,4.49094744243277
"5690",2006-01-24,4,1,-121.4729994,38.52950126,5690,25550,4.49033391915641
"5691",2006-01-24,2,5,-121.4590823,38.6061587,5691,25555,4.49042347566333
"5692",2006-01-24,6,3,-121.4672341,38.55396592,5692,25558,4.4901616303584
"5693",2006-01-24,3,7,-121.4709329,38.57673576,5693,25565,4.49060249429123
"5694",2006-01-24,5,7,-121.4271773,38.4706931,5694,25572,4.49104320337197
"5695",2006-01-24,5,4,-121.4281268,38.47295223,5695,25576,4.49095697980685
"5696",2006-01-24,2,5,-121.4465194,38.60973497,5696,25581,4.49104634831461
"5697",2006-01-24,1,5,-121.5387578,38.65170411,5697,25586,4.49113568544848
"5698",2006-01-24,3,7,-121.5068254,38.57585352,5698,25593,4.49157599157599
"5699",2006-01-24,1,1,-121.5227706,38.6305534,5699,25594,4.49096332689946
"5700",2006-01-24,3,6,-121.464939,38.56811616,5700,25600,4.49122807017544
"5701",2006-01-24,1,3,-121.4904489,38.61291591,5701,25603,4.49096649710577
"5702",2006-01-24,1,6,-121.4959999,38.63020663,5702,25609,4.49123114696598
"5703",2006-01-24,3,7,-121.5037764,38.57868528,5703,25616,4.49167105032439
"5704",2006-01-24,2,3,-121.4477453,38.64394428,5704,25619,4.4914095371669
"5705",2006-01-24,4,1,-121.4717471,38.52488785,5705,25620,4.49079754601227
"5706",2006-01-24,4,1,-121.4745855,38.53627722,5706,25621,4.49018576936558
"5707",2006-01-24,6,3,-121.4254625,38.54146972,5707,25624,4.48992465393377
"5708",2006-01-24,4,1,-121.4741684,38.53452891,5708,25625,4.48931324456903
"5709",2006-01-24,3,2,-121.4855296,38.5952625,5709,25627,4.48887721142056
"5710",2006-01-24,1,3,-121.514569,38.67520381,5710,25630,4.48861646234676
"5711",2006-01-24,3,6,-121.4692575,38.57201606,5711,25636,4.48888110663632
"5712",2006-01-24,4,1,-121.4727965,38.52904451,5712,25637,4.48827030812325
"5713",2006-01-24,3,5,-121.4828749,38.59367176,5713,25642,4.48835988097322
"5714",2006-01-24,4,1,-121.4758022,38.54388351,5714,25643,4.48774938746937
"5715",2006-01-24,4,1,-121.4764341,38.55735796,5715,25644,4.48713910761155
"5716",2006-01-24,2,2,-121.4504263,38.60956685,5716,25646,4.48670398880336
"5717",2006-01-24,5,6,-121.4859396,38.48934244,5717,25652,4.48696868987231
"5718",2006-01-24,4,1,-121.4721784,38.52659231,5718,25653,4.48635886673662
"5719",2006-01-24,4,5,-121.4821968,38.49622629,5719,25658,4.48644867983913
"5720",2006-01-24,3,4,-121.4808628,38.57639629,5720,25662,4.48636363636364
"5721",2006-01-24,1,1,-121.5027081,38.64662608,5721,25663,4.48575423876945
"5722",2006-01-24,4,5,-121.479335,38.55519626,5722,25668,4.48584411045089
"5723",2006-01-24,3,5,-121.4739878,38.56283051,5723,25673,4.48593395072514
"5724",2006-01-24,2,5,-121.4252022,38.63934503,5724,25678,4.48602375960867
"5725",2006-01-24,2,3,-121.4569331,38.60530838,5725,25681,4.48576419213974
"5726",2006-01-24,3,4,-121.43864,38.55792771,5726,25685,4.4856793573175
"5727",2006-01-24,2,3,-121.4590823,38.6061587,5727,25688,4.48541994063209
"5728",2006-01-24,1,1,-121.5252034,38.63583009,5728,25689,4.48481145251397
"5729",2006-01-24,1,4,-121.5210631,38.66845937,5729,25693,4.48472682841683
"5730",2006-01-24,5,4,-121.4859396,38.48934244,5730,25697,4.48464223385689
"5731",2006-01-24,2,5,-121.4155099,38.64205073,5731,25702,4.48473215843657
"5732",2006-01-24,6,3,-121.4383522,38.51585289,5732,25705,4.48447313328681
"5733",2006-01-24,1,1,-121.5221311,38.62776914,5733,25706,4.4838653410082
"5734",2006-01-24,5,3,-121.4530858,38.48230213,5734,25709,4.48360655737705
"5735",2006-01-24,3,5,-121.4093934,38.5554124,5735,25714,4.48369659982563
"5736",2006-01-24,2,9,-121.4336252,38.63722545,5736,25723,4.4844839609484
"5737",2006-01-24,2,5,-121.4253528,38.62197217,5737,25728,4.4845738190692
"5738",2006-01-24,3,5,-121.4847478,38.56204963,5738,25733,4.48466364586964
"5739",2006-01-24,3,3,-121.4979339,38.58026647,5739,25736,4.48440494859732
"5740",2006-01-24,2,4,-121.4328187,38.63651305,5740,25740,4.48432055749129
"5741",2006-01-24,6,7,-121.4264051,38.53293723,5741,25747,4.48475875283052
"5742",2006-01-24,4,1,-121.4811363,38.525334,5742,25748,4.48415186346221
"5743",2006-01-24,2,1,-121.4581955,38.63766971,5743,25749,4.48354518544315
"5744",2006-01-24,3,5,-121.418725,38.57495865,5744,25754,4.48363509749304
"5745",2006-01-24,6,5,-121.4388358,38.53971204,5745,25759,4.48372497824195
"5746",2006-01-24,6,5,-121.3968674,38.50530823,5746,25764,4.48381482770623
"5747",2006-01-24,6,5,-121.4394225,38.51975733,5747,25769,4.48390464590221
"5748",2006-01-24,2,1,-121.4258271,38.6017616,5748,25770,4.48329853862213
"5749",2006-01-24,4,5,-121.5396169,38.47644582,5749,25775,4.48338841537659
"5750",2006-01-24,5,7,-121.4129032,38.43908972,5750,25782,4.48382608695652
"5751",2006-01-24,6,7,-121.4617849,38.5457523,5751,25789,4.48426360632933
"5752",2006-01-24,2,5,-121.3779211,38.63914751,5752,25794,4.48435326842837
"5753",2006-01-24,6,5,-121.427517,38.52507559,5753,25799,4.48444289935686
"5754",2006-01-24,5,5,-121.4196575,38.47581524,5754,25804,4.48453249913104
"5755",2006-01-24,2,2,-121.3779211,38.63914751,5755,25806,4.48410078192876
"5756",2006-01-24,4,4,-121.5284886,38.51549756,5756,25810,4.48401667824878
"5757",2006-01-24,3,3,-121.4839192,38.59345125,5757,25813,4.48375890220601
"5758",2006-01-24,4,2,-121.483171,38.5248104,5758,25815,4.48332754428621
"5759",2006-01-24,2,3,-121.445518,38.61610077,5759,25818,4.48306997742664
"5760",2006-01-24,2,5,-121.4184028,38.63464848,5760,25823,4.48315972222222
"5761",2006-01-24,2,4,-121.462962,38.62491505,5761,25827,4.4830758548863
"5762",2006-01-24,5,7,-121.4665679,38.4840374,5762,25834,4.48351266921208
"5763",2006-01-24,5,7,-121.4399204,38.44603928,5763,25841,4.48394933194517
"5764",2006-01-24,3,5,-121.418725,38.57495865,5764,25846,4.48403886190146
"5765",2006-01-24,2,2,-121.4191898,38.63387807,5765,25848,4.48360797918474
"5766",2006-01-24,3,5,-121.4826293,38.59375853,5766,25853,4.48369753728755
"5767",2006-01-24,3,1,-121.4979339,38.58026647,5767,25854,4.48309346280562
"5768",2006-01-24,4,1,-121.4739615,38.53366299,5768,25855,4.48248959778086
"5769",2006-01-24,3,6,-121.4426296,38.56696743,5769,25861,4.48275264343907
"5770",2006-01-24,4,1,-121.4754644,38.5399031,5770,25862,4.48214904679376
"5771",2006-01-24,5,1,-121.4189709,38.47433721,5771,25863,4.48154565933114
"5772",2006-01-24,4,1,-121.4743108,38.53513366,5772,25864,4.48094248094248
"5773",2006-01-24,2,4,-121.4572426,38.61062598,5773,25868,4.48085917200762
"5774",2006-01-24,5,4,-121.4086541,38.44924455,5774,25872,4.48077589192934
"5775",2006-01-24,2,7,-121.4150713,38.63491454,5775,25879,4.48121212121212
"5776",2006-01-24,4,3,-121.5103761,38.55950557,5776,25882,4.48095567867036
"5777",2006-01-24,2,1,-121.4531229,38.60750643,5777,25883,4.48035312445906
"5778",2006-01-24,3,3,-121.4107934,38.54976013,5778,25886,4.48009691934926
"5779",2006-01-24,2,2,-121.4286413,38.60034763,5779,25888,4.47966776258868
"5780",2006-01-24,4,5,-121.5010951,38.51441882,5780,25893,4.47975778546713
"5781",2006-01-24,4,5,-121.5010951,38.51441882,5781,25898,4.47984777720118
"5782",2006-01-24,3,2,-121.4979339,38.58026647,5782,25900,4.47941888619855
"5783",2006-01-24,2,8,-121.4621144,38.65420479,5783,25908,4.48002766730071
"5784",2006-01-24,1,5,-121.4918261,38.62249154,5784,25913,4.48011756569848
"5785",2006-01-24,3,7,-121.4427953,38.57127936,5785,25920,4.48055315471046
"5786",2006-01-24,4,4,-121.500048,38.54016571,5786,25924,4.48047010024196
"5787",2006-01-24,6,7,-121.4050591,38.50567194,5787,25931,4.48090547779506
"5788",2006-01-24,4,1,-121.4717471,38.52488785,5788,25932,4.48030407740152
"5789",2006-01-24,6,5,-121.4738249,38.54935269,5789,25937,4.48039385040594
"5790",2006-01-24,4,1,-121.4972545,38.56201402,5790,25938,4.47979274611399
"5791",2006-01-24,5,2,-121.4231427,38.4620837,5791,25940,4.47936453116906
"5792",2006-01-24,2,5,-121.4233896,38.60459979,5792,25945,4.4794544198895
"5793",2006-01-24,4,1,-121.4727965,38.52904451,5793,25946,4.47885378905576
"5794",2006-01-24,2,1,-121.4461937,38.61112011,5794,25947,4.47825336555057
"5795",2006-01-24,6,2,-121.4689745,38.55646174,5795,25949,4.47782571182054
"5796",2006-01-24,3,1,-121.4852542,38.56796664,5796,25950,4.47722567287785
"5797",2006-01-24,5,1,-121.4331072,38.48006405,5797,25951,4.47662584095222
"5798",2006-01-24,4,1,-121.4739615,38.53366299,5798,25952,4.47602621593653
"5799",2006-01-24,3,7,-121.4710327,38.57035191,5799,25959,4.47646145887222
"5800",2006-01-24,3,7,-121.4621919,38.57109651,5800,25966,4.47689655172414
"5801",2006-01-24,3,1,-121.4831336,38.56473346,5801,25967,4.47629719013963
"5802",2006-01-24,3,7,-121.4849693,38.57593958,5802,25974,4.47673216132368
"5803",2006-01-24,3,7,-121.4881721,38.56783954,5803,25981,4.47716698259521
"5804",2006-01-24,4,1,-121.4717471,38.52488785,5804,25982,4.47656788421778
"5805",2006-01-24,2,6,-121.3815598,38.63862878,5805,25988,4.47683031869078
"5806",2006-01-24,5,1,-121.4331072,38.48006405,5806,25989,4.47623148467103
"5807",2006-01-24,4,7,-121.5502532,38.49035188,5807,25996,4.47666609264681
"5808",2006-01-24,2,1,-121.4258271,38.6017616,5808,25997,4.47606749311295
"5809",2006-01-24,3,4,-121.4377169,38.55835434,5809,26001,4.47598553967981
"5810",2006-01-24,2,3,-121.4472475,38.62821864,5810,26004,4.47573149741824
"5811",2006-01-24,3,7,-121.4705855,38.56226855,5811,26011,4.47616589227327
"5812",2006-01-24,2,4,-121.4395025,38.62309594,5812,26015,4.47608396421198
"5813",2006-01-24,6,1,-121.4443436,38.52652786,5813,26016,4.47548597970067
"5814",2006-01-24,2,3,-121.4372414,38.60534892,5814,26019,4.47523219814241
"5815",2006-01-24,1,5,-121.5254614,38.60812197,5815,26024,4.47532244196045
"5816",2006-01-24,3,5,-121.411779,38.55575132,5816,26029,4.47541265474553
"5817",2006-01-24,3,4,-121.4770995,38.57011311,5817,26033,4.47533092659446
"5818",2006-01-24,3,5,-121.4970134,38.5803421,5818,26038,4.47542110690959
"5819",2006-01-24,6,5,-121.4136728,38.53381252,5819,26043,4.47551125622959
"5820",2006-01-24,5,7,-121.4856527,38.47824756,5820,26050,4.47594501718213
"5821",2006-01-24,3,2,-121.4873108,38.58354799,5821,26052,4.47551967015977
"5822",2006-01-24,1,7,-121.4884088,38.61872555,5822,26059,4.47595328065957
"5823",2006-01-24,4,7,-121.4778223,38.53874125,5823,26066,4.47638674222909
"5824",2006-01-24,3,5,-121.4855226,38.56713032,5824,26071,4.47647664835165
"5825",2006-01-24,5,1,-121.4684313,38.48151147,5825,26072,4.47587982832618
"5826",2006-01-24,5,5,-121.4709678,38.48524112,5826,26077,4.47596979059389
"5827",2006-01-24,2,2,-121.4438475,38.63014101,5827,26079,4.47554487729535
"5828",2006-01-24,5,7,-121.4348584,38.46977532,5828,26086,4.47597803706246
"5829",2006-01-24,2,4,-121.4444853,38.61701846,5829,26090,4.47589638016813
"5830",2006-01-24,6,1,-121.4538401,38.54675579,5830,26091,4.47530017152659
"5831",2006-01-24,6,4,-121.4605673,38.55465448,5831,26095,4.47521865889213
"5832",2006-01-24,6,3,-121.4224553,38.51688672,5832,26098,4.47496570644719
"5833",2006-01-24,1,8,-121.4769484,38.59836815,5833,26106,4.47557003257329
"5834",2006-01-24,2,8,-121.4219976,38.6066633,5834,26114,4.47617415152554
"5835",2006-01-24,3,5,-121.4805829,38.56824234,5835,26119,4.47626392459297
"5836",2006-01-24,4,8,-121.5419071,38.51042757,5836,26127,4.4768677176148
"5837",2006-01-24,5,5,-121.4774573,38.48306838,5837,26132,4.47695734109988
"5838",2006-01-24,1,5,-121.4971012,38.61601768,5838,26137,4.47704693388147
"5839",2006-01-24,3,4,-121.4521612,38.57052225,5839,26141,4.47696523377291
"5840",2006-01-24,6,8,-121.4714437,38.55500397,5840,26149,4.47756849315068
"5841",2006-01-24,2,5,-121.4472475,38.62821864,5841,26154,4.47765793528505
"5842",2006-01-24,6,1,-121.4649158,38.55301886,5842,26155,4.47706264977747
"5843",2006-01-24,2,5,-121.4472475,38.62821864,5843,26160,4.47715214786925
"5844",2006-01-24,2,5,-121.4472475,38.62821864,5844,26165,4.47724161533196
"5845",2006-01-24,4,1,-121.5016363,38.51449255,5845,26166,4.47664670658683
"5846",2006-01-24,3,6,-121.4839465,38.57129439,5846,26172,4.47690728703387
"5847",2006-01-24,5,1,-121.491628,38.4814126,5847,26173,4.47631263896015
"5848",2006-01-24,3,5,-121.4147524,38.55564283,5848,26178,4.47640218878249
"5849",2006-01-24,3,5,-121.4119063,38.55728421,5849,26183,4.47649170798427
"5850",2006-01-24,1,5,-121.533926,38.60503971,5850,26188,4.4765811965812
"5851",2006-01-24,4,4,-121.5189506,38.51550222,5851,26192,4.47649974363357
"5852",2006-01-24,4,7,-121.5456364,38.50158391,5852,26199,4.47693096377307
"5853",2006-01-24,4,7,-121.4787065,38.54836976,5853,26206,4.47736203656245
"5854",2006-01-24,5,5,-121.4414006,38.47333291,5854,26211,4.47745131533994
"5855",2006-01-24,1,2,-121.4767715,38.63153005,5855,26213,4.47702818104184
"5856",2006-01-24,6,6,-121.4034305,38.50736055,5856,26219,4.47728825136612
"5857",2006-01-24,5,2,-121.42717,38.47421612,5857,26221,4.4768652893973
"5858",2006-01-24,3,2,-121.410072,38.55580579,5858,26223,4.47644247183339
"5859",2006-01-25,6,7,-121.4656547,38.5351352,5859,26230,4.47687318655061
"5860",2006-01-25,5,6,-121.500178,38.49115403,5860,26236,4.47713310580205
"5861",2006-01-25,3,7,-121.4827538,38.57901339,5861,26243,4.47756355570722
"5862",2006-01-25,1,4,-121.5206849,38.681468,5862,26247,4.47748208802456
"5863",2006-01-25,3,7,-121.4802163,38.57871645,5863,26254,4.47791233157087
"5864",2006-01-25,3,7,-121.490882,38.57873639,5864,26261,4.47834242837653
"5865",2006-01-25,4,5,-121.5081919,38.52477943,5865,26266,4.47843137254902
"5866",2006-01-25,4,5,-121.5155483,38.52450018,5866,26271,4.47852028639618
"5867",2006-01-25,3,7,-121.4803293,38.57809363,5867,26278,4.4789500596557
"5868",2006-01-25,3,4,-121.4713893,38.57982154,5868,26282,4.47886843899114
"5869",2006-01-25,6,7,-121.4282022,38.54906486,5869,26289,4.4792980064747
"5870",2006-01-25,4,1,-121.4937694,38.53514629,5870,26290,4.47870528109029
"5871",2006-01-25,6,2,-121.4276732,38.53959695,5871,26292,4.47828308635667
"5872",2006-01-25,3,4,-121.5029189,38.57725646,5872,26296,4.47820163487738
"5873",2006-01-25,3,7,-121.4845539,38.58647665,5873,26303,4.47863102332709
"5874",2006-01-25,3,5,-121.4583676,38.58000574,5874,26308,4.47871978209057
"5875",2006-01-25,3,4,-121.4797242,38.58239929,5875,26312,4.47863829787234
"5876",2006-01-25,6,7,-121.4673106,38.55450173,5876,26319,4.47906739278421
"5877",2006-01-25,6,4,-121.4557181,38.54304388,5877,26323,4.4789858771482
"5878",2006-01-25,5,5,-121.431834,38.44864964,5878,26328,4.4790745151412
"5879",2006-01-25,4,5,-121.4800276,38.51053389,5879,26333,4.4791631229801
"5880",2006-01-25,3,7,-121.5041214,38.57787671,5880,26340,4.47959183673469
"5881",2006-01-25,1,5,-121.5035265,38.63067848,5881,26345,4.47968032647509
"5882",2006-01-25,5,1,-121.4912459,38.4948468,5882,26346,4.47908874532472
"5883",2006-01-25,2,2,-121.4531127,38.61202895,5883,26348,4.47866734659187
"5884",2006-01-25,1,4,-121.5076029,38.62538799,5884,26352,4.47858599592114
"5885",2006-01-25,2,7,-121.462682,38.62444145,5885,26359,4.47901444350043
"5886",2006-01-25,6,3,-121.4606267,38.54679037,5886,26362,4.47876316683656
"5887",2006-01-25,4,4,-121.5292089,38.51385568,5887,26366,4.47868184134534
"5888",2006-01-25,6,5,-121.473693,38.54116369,5888,26371,4.47877038043478
"5889",2006-01-25,3,7,-121.4148963,38.56667405,5889,26378,4.47919850568857
"5890",2006-01-25,4,5,-121.5108445,38.47995503,5890,26383,4.47928692699491
"5891",2006-01-25,5,1,-121.4549812,38.4875421,5891,26384,4.47869631641487
"5892",2006-01-25,2,5,-121.4481729,38.62127582,5892,26389,4.47878479293958
"5893",2006-01-25,1,7,-121.5048798,38.65407136,5893,26396,4.47921262514848
"5894",2006-01-25,3,3,-121.4835098,38.59102751,5894,26399,4.47896165592128
"5895",2006-01-25,3,5,-121.4962231,38.56890733,5895,26404,4.47905004240882
"5896",2006-01-25,1,6,-121.4913982,38.61328803,5896,26410,4.47930800542741
"5897",2006-01-25,3,4,-121.4750103,38.57834697,5897,26414,4.47922672545362
"5898",2006-01-25,1,1,-121.4861775,38.61509104,5898,26415,4.47863682604273
"5899",2006-01-25,3,5,-121.4765951,38.56687886,5899,26420,4.47872520766232
"5900",2006-01-25,3,6,-121.4818667,38.58121716,5900,26426,4.47898305084746
"5901",2006-01-25,3,1,-121.4284238,38.56636818,5901,26427,4.47839349262837
"5902",2006-01-25,5,7,-121.4824978,38.48362651,5902,26434,4.47882073873263
"5903",2006-01-25,4,6,-121.5076046,38.49793266,5903,26440,4.47907843469422
"5904",2006-01-25,6,1,-121.4647617,38.53952458,5904,26441,4.4784891598916
"5905",2006-01-25,3,1,-121.4984069,38.5791674,5905,26442,4.477900084674
"5906",2006-01-25,6,1,-121.4684533,38.5550754,5906,26443,4.47731120894006
"5907",2006-01-25,3,3,-121.4436889,38.56702195,5907,26446,4.47706111393262
"5908",2006-01-25,1,5,-121.4747614,38.63115849,5908,26451,4.47714962762356
"5909",2006-01-25,2,5,-121.423449,38.61499899,5909,26456,4.47723811135556
"5910",2006-01-25,2,7,-121.4385176,38.62860503,5910,26463,4.47766497461929
"5911",2006-01-25,2,5,-121.4484897,38.61833093,5911,26468,4.47775334122822
"5912",2006-01-25,4,3,-121.5276499,38.49488316,5912,26471,4.47750338294993
"5913",2006-01-25,5,9,-121.4892835,38.48586717,5913,26480,4.47826822256046
"5914",2006-01-25,1,5,-121.4853206,38.61355775,5914,26485,4.47835644234021
"5915",2006-01-25,3,3,-121.4800802,38.57818313,5915,26488,4.47810650887574
"5916",2006-01-25,4,4,-121.5427657,38.51006027,5916,26492,4.47802569303583
"5917",2006-01-25,3,3,-121.4874147,38.56276169,5917,26495,4.4777758999493
"5918",2006-01-25,5,5,-121.4512387,38.47990166,5918,26500,4.47786414329165
"5919",2006-01-25,6,3,-121.4278799,38.54826969,5919,26503,4.47761446190235
"5920",2006-01-25,6,2,-121.4564199,38.54501602,5920,26505,4.47719594594595
"5921",2006-01-25,5,3,-121.4902673,38.49536971,5921,26508,4.47694646174633
"5922",2006-01-25,6,1,-121.4689574,38.53385981,5922,26509,4.47635933806147
"5923",2006-01-25,5,3,-121.440804,38.44512092,5923,26512,4.47611007935168
"5924",2006-01-25,6,6,-121.4572509,38.54010468,5924,26518,4.4763673193788
"5925",2006-01-25,4,3,-121.5302929,38.51270679,5925,26521,4.47611814345992
"5926",2006-01-25,3,7,-121.4192296,38.57227839,5926,26528,4.47654404319946
"5927",2006-01-25,4,7,-121.4943622,38.56250667,5927,26535,4.47696979922389
"5928",2006-01-25,6,1,-121.4538401,38.54675579,5928,26536,4.47638326585695
"5929",2006-01-25,5,3,-121.4426705,38.4538236,5929,26539,4.47613425535503
"5930",2006-01-25,3,1,-121.4979339,38.58026647,5930,26540,4.47554806070826
"5931",2006-01-25,4,4,-121.5320589,38.50081583,5931,26544,4.47546788062721
"5932",2006-01-25,4,3,-121.4949091,38.56330538,5932,26547,4.47521915037087
"5933",2006-01-25,3,1,-121.3982115,38.54900615,5933,26548,4.47463340637114
"5934",2006-01-25,3,3,-121.4869857,38.57766475,5934,26551,4.47438490057297
"5935",2006-01-25,6,1,-121.4514664,38.54032454,5935,26552,4.47379949452401
"5936",2006-01-25,2,1,-121.4282908,38.64494007,5936,26553,4.47321428571429
"5937",2006-01-25,5,3,-121.4673944,38.49407763,5937,26556,4.47296614451743
"5938",2006-01-25,2,5,-121.4261103,38.61266168,5938,26561,4.47305490063995
"5939",2006-01-25,5,5,-121.4097842,38.44896749,5939,26566,4.47314362687321
"5940",2006-01-25,6,2,-121.4686118,38.53425638,5940,26568,4.47272727272727
"5941",2006-01-25,6,1,-121.4538401,38.54675579,5941,26569,4.47214273691298
"5942",2006-01-25,6,1,-121.455882,38.54676816,5942,26570,4.47155839784584
"5943",2006-01-25,6,1,-121.471902,38.55735109,5943,26571,4.47097425542655
"5944",2006-01-25,3,5,-121.4677888,38.57711951,5944,26576,4.47106325706595
"5945",2006-01-25,3,1,-121.4375953,38.56181365,5945,26577,4.47047939444912
"5946",2006-01-25,4,2,-121.4808562,38.53789542,5946,26579,4.47006390850992
"5947",2006-01-25,6,1,-121.4467668,38.54672494,5947,26580,4.4694804102909
"5948",2006-01-25,2,5,-121.4434361,38.65771652,5948,26585,4.46956960322798
"5949",2006-01-25,6,1,-121.4652524,38.54963467,5949,26586,4.46898638426626
"5950",2006-01-25,2,5,-121.4574188,38.62058633,5950,26591,4.4690756302521
"5951",2006-01-25,2,1,-121.4277987,38.64430882,5951,26592,4.46849269030415
"5952",2006-01-25,4,3,-121.5076289,38.48123472,5952,26595,4.46824596774194
"5953",2006-01-25,3,7,-121.4063761,38.55743172,5953,26602,4.46867125818915
"5954",2006-01-25,1,7,-121.5376811,38.68165784,5954,26609,4.46909640577763
"5955",2006-01-25,3,1,-121.4096655,38.54915301,5955,26610,4.46851385390428
"5956",2006-01-25,2,5,-121.4206076,38.59683958,5956,26615,4.46860308932169
"5957",2006-01-25,3,4,-121.4935219,38.57100991,5957,26619,4.46852442504616
"5958",2006-01-25,4,5,-121.5006857,38.51898355,5958,26624,4.46861362873447
"5959",2006-01-25,6,1,-121.4554708,38.55117621,5959,26625,4.4680315489176
"5960",2006-01-25,3,7,-121.4748628,38.5670193,5960,26632,4.46845637583893
"5961",2006-01-25,6,6,-121.4614322,38.55727813,5961,26638,4.46871330313706
"5962",2006-01-25,5,4,-121.4436724,38.4735965,5962,26642,4.46863468634686
"5963",2006-01-25,5,7,-121.419539,38.46030551,5963,26649,4.46905919839007
"5964",2006-01-25,4,7,-121.4757183,38.54435543,5964,26656,4.46948356807512
"5965",2006-01-25,4,8,-121.5510111,38.49261747,5965,26664,4.47007544006706
"5966",2006-01-25,6,1,-121.4728661,38.55513128,5966,26665,4.46949379818974
"5967",2006-01-25,3,3,-121.4966071,38.57991197,5967,26668,4.46924752807106
"5968",2006-01-25,4,2,-121.480381,38.50039746,5968,26670,4.46883378016086
"5969",2006-01-25,2,2,-121.4174182,38.6369007,5969,26672,4.46842017088289
"5970",2006-01-25,6,3,-121.4254625,38.54146972,5970,26675,4.46817420435511
"5971",2006-01-25,2,5,-121.422231,38.61370233,5971,26680,4.46826327248367
"5972",2006-01-25,3,5,-121.3870109,38.5490874,5972,26685,4.46835231078366
"5973",2006-01-25,4,6,-121.4908853,38.5488551,5973,26691,4.46860873932697
"5974",2006-01-25,6,1,-121.4667332,38.55033897,5974,26692,4.4680281218614
"5975",2006-01-25,6,3,-121.4286068,38.53958509,5975,26695,4.46778242677824
"5976",2006-01-25,3,5,-121.4856685,38.59007055,5976,26700,4.46787148594377
"5977",2006-01-25,5,1,-121.4355908,38.47345298,5977,26701,4.46729128325247
"5978",2006-01-25,6,1,-121.4554708,38.55117621,5978,26702,4.4667112746738
"5979",2006-01-25,4,3,-121.4973097,38.52289837,5979,26705,4.46646596420806
"5980",2006-01-25,3,5,-121.5032275,38.58165678,5980,26710,4.46655518394649
"5981",2006-01-25,2,2,-121.425595,38.64317482,5981,26712,4.46614278548738
"5982",2006-01-25,6,1,-121.453002,38.54524705,5982,26713,4.46556335673688
"5983",2006-01-25,6,1,-121.4687673,38.55187781,5983,26714,4.46498412167809
"5984",2006-01-25,4,3,-121.4990149,38.52199137,5984,26717,4.46473930481283
"5985",2006-01-25,4,4,-121.4840933,38.52438889,5985,26721,4.46466165413534
"5986",2006-01-25,5,6,-121.4828734,38.47998982,5986,26727,4.46491814233211
"5987",2006-01-25,1,6,-121.4954411,38.62210918,5987,26733,4.46517454484717
"5988",2006-01-25,5,3,-121.4832865,38.49050038,5988,26736,4.46492985971944
"5989",2006-01-25,6,1,-121.4704591,38.55385441,5989,26737,4.46435131073635
"5990",2006-01-25,6,1,-121.4687673,38.55187781,5990,26738,4.46377295492487
"5991",2006-01-25,2,5,-121.4291563,38.64268168,5991,26743,4.4638624603572
"5992",2006-01-25,2,4,-121.4258271,38.6017616,5992,26747,4.46378504672897
"5993",2006-01-25,3,4,-121.4848294,38.57642774,5993,26751,4.46370765893542
"5994",2006-01-25,2,7,-121.4472475,38.62821864,5994,26758,4.46413079746413
"5995",2006-01-25,6,5,-121.3802909,38.51236009,5995,26763,4.46422018348624
"5996",2006-01-25,2,3,-121.4381004,38.6051444,5996,26766,4.46397598398933
"5997",2006-01-25,2,4,-121.4286413,38.60034763,5997,26770,4.46389861597465
"5998",2006-01-25,6,7,-121.4270608,38.50482469,5998,26777,4.46432144048016
"5999",2006-01-25,2,5,-121.4644292,38.62298046,5999,26782,4.46441073512252
"6000",2006-01-25,3,3,-121.4920473,38.58358534,6000,26785,4.46416666666667
"6001",2006-01-25,6,1,-121.4678177,38.55120344,6001,26786,4.46358940176637
"6002",2006-01-25,4,1,-121.4972545,38.56201402,6002,26787,4.46301232922359
"6003",2006-01-25,3,3,-121.3893645,38.56048459,6003,26790,4.46276861569215
"6004",2006-01-25,6,1,-121.4689027,38.55060706,6004,26791,4.46219187208528
"6005",2006-01-25,2,1,-121.4258271,38.6017616,6005,26792,4.4616153205662
"6006",2006-01-25,3,7,-121.4840539,38.58933294,6006,26799,4.46203796203796
"6007",2006-01-25,2,4,-121.4199118,38.62302147,6007,26803,4.46196104544698
"6008",2006-01-25,3,1,-121.4887072,38.59127025,6008,26804,4.46138482023968
"6009",2006-01-25,3,4,-121.4505999,38.56887003,6009,26808,4.46130803794308
"6010",2006-01-25,6,7,-121.3911196,38.51301073,6010,26815,4.46173044925125
"6011",2006-01-25,6,7,-121.4387144,38.52224996,6011,26822,4.46215272001331
"6012",2006-01-25,2,4,-121.4303406,38.59657483,6012,26826,4.46207584830339
"6013",2006-01-25,4,5,-121.5190249,38.50707525,6013,26831,4.46216530849825
"6014",2006-01-25,2,1,-121.4258271,38.6017616,6014,26832,4.46158962421018
"6015",2006-01-25,6,1,-121.469478,38.5527076,6015,26833,4.46101413133832
"6016",2006-01-25,5,9,-121.4983924,38.47426976,6016,26842,4.46176861702128
"6017",2006-01-25,2,5,-121.4461619,38.61655968,6017,26847,4.46185806880505
"6018",2006-01-25,2,7,-121.4464861,38.64062392,6018,26854,4.46227982718511
"6019",2006-01-25,6,5,-121.4243199,38.50713141,6019,26859,4.46236916431301
"6020",2006-01-25,5,5,-121.4627597,38.49940254,6020,26864,4.4624584717608
"6021",2006-01-25,4,5,-121.5072531,38.56559378,6021,26869,4.46254774954327
"6022",2006-01-25,3,2,-121.3927171,38.5470745,6022,26871,4.46213882431086
"6023",2006-01-25,6,3,-121.4459336,38.5319862,6023,26874,4.46189606508385
"6024",2006-01-25,6,5,-121.41256,38.51993158,6024,26879,4.46198539176627
"6025",2006-01-25,3,6,-121.4966071,38.57991197,6025,26885,4.46224066390042
"6026",2006-01-25,2,6,-121.4619761,38.61084302,6026,26891,4.46249585131099
"6027",2006-01-25,6,1,-121.469478,38.5527076,6027,26892,4.46192135390742
"6028",2006-01-25,4,4,-121.5047395,38.56089025,6028,26896,4.46184472461845
"6029",2006-01-25,5,2,-121.4555792,38.48791288,6029,26898,4.46143639077791
"6030",2006-01-25,3,7,-121.4817231,38.56150067,6030,26905,4.46185737976783
"6031",2006-01-25,2,6,-121.4250633,38.61924127,6031,26911,4.46211241916763
"6032",2006-01-25,6,1,-121.464715,38.54528535,6032,26912,4.46153846153846
"6033",2006-01-25,6,3,-121.3699458,38.51476184,6033,26915,4.46129620421018
"6034",2006-01-25,5,7,-121.4519324,38.46872071,6034,26922,4.46171693735499
"6035",2006-01-25,2,6,-121.3815598,38.63862878,6035,26928,4.46197183098592
"6036",2006-01-25,4,7,-121.4918839,38.54120381,6036,26935,4.46239231278993
"6037",2006-01-25,3,3,-121.4847429,38.579198,6037,26938,4.46215007454033
"6038",2006-01-25,3,2,-121.5046032,38.58203886,6038,26940,4.46174229877443
"6039",2006-01-25,5,7,-121.4597045,38.49356691,6039,26947,4.46216260970359
"6040",2006-01-25,3,1,-121.4832039,38.5820634,6040,26948,4.46158940397351
"6041",2006-01-25,2,5,-121.4438767,38.6120344,6041,26953,4.46167853004469
"6042",2006-01-25,6,3,-121.4724356,38.55612335,6042,26956,4.46143661039391
"6043",2006-01-25,2,7,-121.4264174,38.59753852,6043,26963,4.46185669369518
"6044",2006-01-25,3,4,-121.4135687,38.5732988,6044,26967,4.46178027796161
"6045",2006-01-25,3,7,-121.4865708,38.5701967,6045,26974,4.46220016542597
"6046",2006-01-25,2,3,-121.4257578,38.60558911,6046,26977,4.46195831955012
"6047",2006-01-25,2,8,-121.4569468,38.61684415,6047,26985,4.46254340995535
"6048",2006-01-25,3,5,-121.3935632,38.55408112,6048,26990,4.46263227513228
"6049",2006-01-25,3,5,-121.4812732,38.58105799,6049,26995,4.46272111092743
"6050",2006-01-25,1,3,-121.5093439,38.66842409,6050,26998,4.46247933884298
"6051",2006-01-25,2,5,-121.4137628,38.63991928,6051,27003,4.46256817055032
"6052",2006-01-25,5,4,-121.4774573,38.48306838,6052,27007,4.46249173826834
"6053",2006-01-25,6,4,-121.4672369,38.53064464,6053,27011,4.46241533124071
"6054",2006-01-25,3,8,-121.4884229,38.58506592,6054,27019,4.46299966963991
"6055",2006-01-25,3,6,-121.4986248,38.58052209,6055,27025,4.46325350949628
"6056",2006-01-25,6,8,-121.4614322,38.55727813,6056,27033,4.46383751651255
"6057",2006-01-25,3,7,-121.4996535,38.56602524,6057,27040,4.46425623245831
"6058",2006-01-25,3,3,-121.4263983,38.56990044,6058,27043,4.46401452624629
"6059",2006-01-25,3,1,-121.5052755,38.58245363,6059,27044,4.46344281234527
"6060",2006-01-25,5,7,-121.4847037,38.49502927,6060,27051,4.46386138613861
"6061",2006-01-25,5,4,-121.4133413,38.45718227,6061,27055,4.46378485398449
"6062",2006-01-25,2,5,-121.4477453,38.64394428,6062,27060,4.4638733091389
"6063",2006-01-25,1,7,-121.5283878,38.61330451,6063,27067,4.4642916048161
"6064",2006-01-25,2,1,-121.4252477,38.60027317,6064,27068,4.46372031662269
"6065",2006-01-25,6,6,-121.4386909,38.53368123,6065,27074,4.46397361912613
"6066",2006-01-25,4,7,-121.500048,38.54016571,6066,27081,4.46439169139466
"6067",2006-01-25,3,7,-121.4913297,38.5674553,6067,27088,4.46480962584473
"6068",2006-01-25,4,7,-121.5187359,38.48255011,6068,27095,4.4652274225445
"6069",2006-01-25,2,1,-121.423349,38.59664183,6069,27096,4.46465645081562
"6070",2006-01-25,2,4,-121.4270748,38.64724615,6070,27100,4.46457990115321
"6071",2006-01-25,5,5,-121.4309608,38.48024572,6071,27105,4.46466809421842
"6072",2006-01-25,6,5,-121.4405784,38.52568868,6072,27110,4.46475625823452
"6073",2006-01-25,6,1,-121.4526742,38.54058014,6073,27111,4.46418574016137
"6074",2006-01-25,3,3,-121.5052992,38.58054256,6074,27114,4.46394468225222
"6075",2006-01-25,5,3,-121.4271773,38.4706931,6075,27117,4.4637037037037
"6076",2006-01-25,5,2,-121.4465943,38.47427504,6076,27119,4.46329822251481
"6077",2006-01-25,2,6,-121.3815598,38.63862878,6077,27125,4.46355109428995
"6078",2006-01-25,6,3,-121.4662539,38.54990015,6078,27128,4.46331029944061
"6079",2006-01-25,5,2,-121.4196575,38.47581524,6079,27130,4.46290508307287
"6080",2006-01-25,5,1,-121.4196758,38.4748515,6080,27131,4.46233552631579
"6081",2006-01-25,2,2,-121.4591775,38.61713742,6081,27133,4.46193060351916
"6082",2006-01-25,2,5,-121.4494903,38.60297489,6082,27138,4.46201907267346
"6083",2006-01-25,1,6,-121.4873914,38.62149994,6083,27144,4.46227190530988
"6084",2006-01-25,1,7,-121.499019,38.66336311,6084,27151,4.46268902038133
"6085",2006-01-25,3,7,-121.4064316,38.56758379,6085,27158,4.46310599835661
"6086",2006-01-25,5,1,-121.4196758,38.4748515,6086,27159,4.4625369700953
"6087",2006-01-25,6,7,-121.4676269,38.54116339,6087,27166,4.46295383604403
"6088",2006-01-25,4,9,-121.4788756,38.49838615,6088,27175,4.46369908015769
"6089",2006-01-25,6,3,-121.4648791,38.54904531,6089,27178,4.4634586960092
"6090",2006-01-25,3,7,-121.4102219,38.55502121,6090,27185,4.46387520525452
"6091",2006-01-25,5,1,-121.4196758,38.4748515,6091,27186,4.46330651781317
"6092",2006-01-25,3,7,-121.4905778,38.58165673,6092,27193,4.46372291529875
"6093",2006-01-25,6,5,-121.4560574,38.5448578,6093,27198,4.46381093057607
"6094",2006-01-25,3,4,-121.487703,38.5766684,6094,27202,4.46373482113554
"6095",2006-01-25,3,7,-121.4192296,38.57227839,6095,27209,4.46415094339623
"6096",2006-01-25,5,6,-121.4411429,38.45090003,6096,27215,4.46440288713911
"6097",2006-01-25,5,2,-121.4196649,38.46716553,6097,27217,4.46399868787929
"6098",2006-01-25,1,5,-121.4925571,38.61421301,6098,27222,4.46408658576583
"6099",2006-01-25,5,5,-121.4196758,38.4748515,6099,27227,4.46417445482866
"6100",2006-01-25,5,1,-121.4196758,38.4748515,6100,27228,4.46360655737705
"6101",2006-01-25,6,8,-121.4333041,38.50632179,6101,27236,4.46418619898377
"6102",2006-01-25,5,1,-121.4196758,38.4748515,6102,27237,4.46361848574238
"6103",2006-01-25,3,4,-121.4894307,38.57182945,6103,27241,4.4635425200721
"6104",2006-01-25,6,7,-121.4361099,38.51787398,6104,27248,4.46395806028834
"6105",2006-01-25,5,6,-121.4724244,38.48149132,6105,27254,4.46420966420966
"6106",2006-01-25,6,2,-121.4364293,38.50575492,6106,27256,4.46380609236816
"6107",2006-01-25,3,4,-121.4667631,38.57161193,6107,27260,4.4637301457344
"6108",2006-01-26,4,7,-121.4935943,38.53124355,6108,27267,4.46414538310413
"6109",2006-01-26,3,5,-121.3882189,38.54929974,6109,27272,4.46423309870683
"6110",2006-01-26,5,7,-121.4806587,38.48383794,6110,27279,4.46464811783961
"6111",2006-01-26,3,7,-121.4935172,38.57217417,6111,27286,4.46506300114548
"6112",2006-01-26,3,4,-121.4825153,38.58006128,6112,27290,4.46498691099476
"6113",2006-01-26,5,7,-121.4229307,38.47708652,6113,27297,4.46540160314085
"6114",2006-01-26,4,7,-121.479928,38.53908574,6114,27304,4.46581615963363
"6115",2006-01-26,1,4,-121.5270605,38.62715506,6115,27308,4.46573998364677
"6116",2006-01-26,4,4,-121.5408716,38.48124245,6116,27312,4.46566383257031
"6117",2006-01-26,3,7,-121.4849475,38.56975838,6117,27319,4.4660781428805
"6118",2006-01-26,1,7,-121.4921486,38.63028592,6118,27326,4.4664923177509
"6119",2006-01-26,6,3,-121.4659749,38.54325918,6119,27329,4.46625265566269
"6120",2006-01-26,4,6,-121.4990149,38.52199137,6120,27335,4.46650326797386
"6121",2006-01-26,6,4,-121.4359118,38.5057826,6121,27339,4.46642705440288
"6122",2006-01-26,6,2,-121.4598507,38.54213786,6122,27341,4.46602417510617
"6123",2006-01-26,2,5,-121.4608861,38.60826775,6123,27346,4.46611138330884
"6124",2006-01-26,6,4,-121.4571284,38.54057916,6124,27350,4.46603527106466
"6125",2006-01-26,1,4,-121.4872155,38.61335197,6125,27354,4.46595918367347
"6126",2006-01-26,5,5,-121.42717,38.47421612,6126,27359,4.466046359778
"6127",2006-01-26,6,7,-121.4239241,38.51461765,6127,27366,4.46645993145095
"6128",2006-01-26,6,7,-121.4447335,38.53572042,6128,27373,4.46687336814621
"6129",2006-01-26,1,7,-121.502068,38.61195044,6129,27380,4.46728666992984
"6130",2006-01-26,6,1,-121.4683381,38.54847637,6130,27381,4.46672104404568
"6131",2006-01-26,4,6,-121.4712477,38.52718667,6131,27387,4.46697113032132
"6132",2006-01-26,2,5,-121.4546092,38.61038295,6132,27392,4.46705805609915
"6133",2006-01-26,4,1,-121.4894813,38.50854126,6133,27393,4.46649274417088
"6134",2006-01-26,5,7,-121.4190329,38.43922779,6134,27400,4.46690577111184
"6135",2006-01-26,2,2,-121.4237298,38.59800846,6135,27402,4.46650366748166
"6136",2006-01-26,3,3,-121.4031406,38.5688053,6136,27405,4.46626466753585
"6137",2006-01-26,4,5,-121.4749018,38.52274391,6137,27410,4.46635163760795
"6138",2006-01-26,6,7,-121.4180143,38.51029065,6138,27417,4.46676441837732
"6139",2006-01-26,1,5,-121.5215017,38.66835409,6139,27422,4.46685127870989
"6140",2006-01-26,2,5,-121.4223802,38.61041617,6140,27427,4.46693811074919
"6141",2006-01-26,2,7,-121.452735,38.64756239,6141,27434,4.46735059436574
"6142",2006-01-26,2,1,-121.4316807,38.59613108,6142,27435,4.46678606317161
"6143",2006-01-26,3,3,-121.4932417,38.58682254,6143,27438,4.46654728959792
"6144",2006-01-26,6,5,-121.4347587,38.51637084,6144,27443,4.46663411458333
"6145",2006-01-26,4,7,-121.5418098,38.4999899,6145,27450,4.46704637917006
"6146",2006-01-26,6,5,-121.4091236,38.52506274,6146,27455,4.46713309469574
"6147",2006-01-26,3,7,-121.4113171,38.56130403,6147,27462,4.46754514397267
"6148",2006-01-26,5,6,-121.4891105,38.48368063,6148,27468,4.46779440468445
"6149",2006-01-26,1,7,-121.4818759,38.61607415,6149,27475,4.46820621239226
"6150",2006-01-26,3,3,-121.4274073,38.55269382,6150,27478,4.4679674796748
"6151",2006-01-26,1,4,-121.5025952,38.67987056,6151,27482,4.46789139977239
"6152",2006-01-26,4,6,-121.51329,38.50710344,6152,27488,4.46814044213264
"6153",2006-01-26,2,1,-121.4430328,38.64749419,6153,27489,4.46757679180887
"6154",2006-01-26,6,5,-121.4259032,38.50710633,6154,27494,4.46766330841729
"6155",2006-01-26,5,6,-121.4673944,38.49407763,6155,27500,4.46791226645004
"6156",2006-01-26,2,6,-121.4447167,38.6389926,6156,27506,4.46816114359974
"6157",2006-01-26,5,1,-121.4933503,38.48140918,6157,27507,4.46759785609875
"6158",2006-01-26,2,1,-121.4325857,38.626632,6158,27508,4.46703475154271
"6159",2006-01-26,2,1,-121.433145,38.62541828,6159,27509,4.46647182984251
"6160",2006-01-26,4,2,-121.4712477,38.52718667,6160,27511,4.46607142857143
"6161",2006-01-26,2,1,-121.433145,38.62541828,6161,27512,4.46550884596656
"6162",2006-01-26,2,2,-121.4461973,38.60930232,6162,27514,4.46510873093152
"6163",2006-01-26,3,5,-121.4070072,38.55050416,6163,27519,4.46519552166153
"6164",2006-01-26,5,7,-121.4294237,38.47193989,6164,27526,4.46560674886437
"6165",2006-01-26,2,1,-121.4313085,38.63008563,6165,27527,4.46504460665045
"6166",2006-01-26,2,1,-121.4514503,38.61021151,6166,27528,4.46448264677262
"6167",2006-01-26,2,5,-121.425595,38.64317482,6167,27533,4.46456948273066
"6168",2006-01-26,6,5,-121.4152408,38.51610082,6168,27538,4.46465629053178
"6169",2006-01-26,6,3,-121.4647145,38.52903211,6169,27541,4.46441886853623
"6170",2006-01-26,1,7,-121.5373039,38.6836334,6170,27548,4.46482982171799
"6171",2006-01-26,5,6,-121.4636952,38.48789589,6171,27554,4.46507859342084
"6172",2006-01-26,5,5,-121.4550456,38.48046885,6172,27559,4.4651652624757
"6173",2006-01-26,4,1,-121.5044547,38.55255786,6173,27560,4.46460392029807
"6174",2006-01-26,3,1,-121.5000936,38.58207989,6174,27561,4.46404275996113
"6175",2006-01-26,2,1,-121.4487064,38.61112661,6175,27562,4.46348178137652
"6176",2006-01-26,1,3,-121.510985,38.6206848,6176,27565,4.46324481865285
"6177",2006-01-26,4,5,-121.4734551,38.53312798,6177,27570,4.46333171442448
"6178",2006-01-26,6,9,-121.4566752,38.54454492,6178,27579,4.4640660407899
"6179",2006-01-26,1,2,-121.5556894,38.65550746,6179,27581,4.46366726007445
"6180",2006-01-26,2,1,-121.4364722,38.62031333,6180,27582,4.4631067961165
"6181",2006-01-26,4,7,-121.4953461,38.53218208,6181,27589,4.46351723022165
"6182",2006-01-26,3,5,-121.4736865,38.57381016,6182,27594,4.46360401164672
"6183",2006-01-26,5,3,-121.4866458,38.4756653,6183,27597,4.46336729742843
"6184",2006-01-26,2,1,-121.4291698,38.64011428,6184,27598,4.46280724450194
"6185",2006-01-26,5,2,-121.4866458,38.4756653,6185,27600,4.4624090541633
"6186",2006-01-26,3,7,-121.481959,38.5906691,6186,27607,4.46281926931781
"6187",2006-01-26,3,1,-121.4865389,38.57315943,6187,27608,4.46225957653144
"6188",2006-01-26,6,3,-121.4498884,38.55544996,6188,27611,4.4620232708468
"6189",2006-01-26,2,5,-121.42747,38.60154457,6189,27616,4.46211019550816
"6190",2006-01-26,2,8,-121.4259795,38.59803885,6190,27624,4.4626817447496
"6191",2006-01-26,5,7,-121.4757532,38.482495,6191,27631,4.46309158455823
"6192",2006-01-26,5,7,-121.429528,38.47157245,6192,27638,4.46350129198966
"6193",2006-01-26,2,1,-121.4576293,38.64444404,6193,27639,4.46294203132569
"6194",2006-01-26,2,5,-121.4495678,38.63737093,6194,27644,4.46302873748789
"6195",2006-01-26,2,1,-121.4427075,38.61564793,6195,27645,4.46246973365617
"6196",2006-01-26,6,2,-121.4425904,38.52497346,6196,27647,4.46207230471272
"6197",2006-01-26,5,7,-121.4133413,38.45718227,6197,27654,4.46248184605454
"6198",2006-01-26,5,5,-121.4933503,38.48140918,6198,27659,4.46256857050662
"6199",2006-01-26,6,1,-121.4564781,38.54471974,6199,27660,4.46201000161316
"6200",2006-01-26,3,5,-121.4671338,38.56833498,6200,27665,4.46209677419355
"6201",2006-01-26,3,3,-121.4277082,38.57970173,6201,27668,4.46186099016288
"6202",2006-01-26,5,7,-121.4986814,38.48784967,6202,27675,4.46227023540793
"6203",2006-01-26,5,7,-121.4370954,38.47267772,6203,27682,4.46267934870224
"6204",2006-01-26,5,7,-121.4129032,38.43908972,6204,27689,4.46308833010961
"6205",2006-01-26,3,1,-121.4403257,38.56148913,6205,27690,4.46253021756648
"6206",2006-01-26,2,1,-121.4312633,38.63312517,6206,27691,4.46197228488559
"6207",2006-01-26,2,1,-121.4291647,38.64074857,6207,27692,4.46141453198002
"6208",2006-01-26,2,1,-121.4427075,38.61564793,6208,27693,4.46085695876289
"6209",2006-01-26,3,6,-121.4817091,38.575947,6209,27699,4.46110484780158
"6210",2006-01-26,2,1,-121.4427075,38.61564793,6210,27700,4.46054750402577
"6211",2006-01-26,5,7,-121.4348784,38.47431447,6211,27707,4.46095636773466
"6212",2006-01-26,2,5,-121.4164146,38.63248017,6212,27712,4.46104314230522
"6213",2006-01-26,3,3,-121.4994087,38.58197259,6213,27715,4.4608079832609
"6214",2006-01-26,2,7,-121.4399954,38.64145221,6214,27722,4.46121660766012
"6215",2006-01-26,6,7,-121.4462065,38.53106486,6215,27729,4.46162510056315
"6216",2006-01-26,2,1,-121.4301867,38.63466859,6216,27730,4.46106821106821
"6217",2006-01-26,2,3,-121.4280253,38.59513553,6217,27733,4.46083319929226
"6218",2006-01-26,2,1,-121.4359282,38.62404517,6218,27734,4.46027661627533
"6219",2006-01-26,3,4,-121.4711377,38.56940229,6219,27738,4.46020260492041
"6220",2006-01-26,5,7,-121.4664647,38.48054957,6220,27745,4.46061093247588
"6221",2006-01-26,2,3,-121.425346,38.63279391,6221,27748,4.46037614531426
"6222",2006-01-26,3,3,-121.4818128,38.56263789,6222,27751,4.46014143362263
"6223",2006-01-26,5,4,-121.4116082,38.4411728,6223,27755,4.46006749156355
"6224",2006-01-26,4,1,-121.5091926,38.56073073,6224,27756,4.45951156812339
"6225",2006-01-26,3,3,-121.4819129,38.56859703,6225,27759,4.45927710843374
"6226",2006-01-26,2,1,-121.433145,38.62541828,6226,27760,4.45872149052361
"6227",2006-01-26,2,1,-121.4297591,38.63647881,6227,27761,4.45816605106793
"6228",2006-01-26,1,1,-121.5084533,38.6274483,6228,27762,4.45761078998073
"6229",2006-01-26,4,1,-121.505882,38.56307815,6229,27763,4.45705570717611
"6230",2006-01-26,3,9,-121.455665,38.56055178,6230,27772,4.4577849117175
"6231",2006-01-26,2,6,-121.3815598,38.63862878,6231,27778,4.4580324185524
"6232",2006-01-26,4,1,-121.5173431,38.525812,6232,27779,4.45747753530167
"6233",2006-01-26,3,5,-121.4692124,38.5738419,6233,27784,4.45756457564576
"6234",2006-01-26,2,6,-121.4600477,38.60668493,6234,27790,4.45781199871672
"6235",2006-01-26,5,4,-121.450353,38.46971274,6235,27794,4.45773857257418
"6236",2006-01-26,2,5,-121.4317459,38.62879718,6236,27799,4.45782552918538
"6237",2006-01-26,2,3,-121.4317459,38.62879718,6237,27802,4.45759179092512
"6238",2006-01-26,5,3,-121.4982461,38.47620226,6238,27805,4.457358127605
"6239",2006-01-26,4,8,-121.4960208,38.55199422,6239,27813,4.45792594967142
"6240",2006-01-26,1,6,-121.5115613,38.62700562,6240,27819,4.45817307692308
"6241",2006-01-26,3,4,-121.5021475,38.57550673,6241,27823,4.45809966351546
"6242",2006-01-26,6,5,-121.407542,38.53157904,6242,27828,4.45818647869273
"6243",2006-01-26,2,1,-121.4356686,38.62278626,6243,27829,4.45763254845427
"6244",2006-01-26,4,1,-121.5120281,38.55777986,6244,27830,4.45707879564382
"6245",2006-01-26,4,1,-121.5111836,38.5590559,6245,27831,4.45652522017614
"6246",2006-01-26,6,6,-121.4181141,38.50576856,6246,27837,4.45677233429395
"6247",2006-01-26,2,1,-121.4306582,38.63393225,6247,27838,4.45621898511285
"6248",2006-01-26,2,5,-121.4207473,38.62013416,6248,27843,4.45630601792574
"6249",2006-01-26,2,1,-121.4360584,38.62130809,6249,27844,4.45575292046727
"6250",2006-01-26,5,7,-121.4425627,38.47390968,6250,27851,4.45616
"6251",2006-01-26,3,5,-121.5046032,38.58203886,6251,27856,4.45624700047992
"6252",2006-01-26,6,3,-121.4702323,38.55096189,6252,27859,4.45601407549584
"6253",2006-01-26,5,7,-121.4352434,38.44801831,6253,27866,4.45642091795938
"6254",2006-01-26,5,8,-121.4297711,38.47087617,6254,27874,4.45698752798209
"6255",2006-01-26,6,5,-121.4283286,38.53851829,6255,27879,4.45707434052758
"6256",2006-01-26,2,1,-121.4370121,38.61843224,6256,27880,4.45652173913043
"6257",2006-01-26,1,1,-121.4859274,38.62259183,6257,27881,4.45596931436791
"6258",2006-01-26,2,1,-121.4460587,38.61363201,6258,27882,4.45541706615532
"6259",2006-01-26,4,7,-121.5251663,38.48899394,6259,27889,4.45582361399585
"6260",2006-01-26,3,2,-121.4966071,38.57991197,6260,27891,4.45543130990415
"6261",2006-01-26,6,5,-121.4243199,38.50713141,6261,27896,4.45551828781345
"6262",2006-01-26,5,6,-121.4806581,38.48823968,6262,27902,4.45576493133184
"6263",2006-01-26,5,8,-121.4859396,38.48934244,6263,27910,4.45633083186971
"6264",2006-01-26,2,5,-121.4412303,38.62863462,6264,27915,4.45641762452107
"6265",2006-01-26,6,4,-121.3884382,38.52615247,6265,27919,4.45634477254589
"6266",2006-01-26,2,1,-121.4427075,38.61564793,6266,27920,4.45579316948612
"6267",2006-01-26,5,5,-121.4097064,38.44613053,6267,27925,4.45588000638264
"6268",2006-01-26,3,1,-121.486043,38.58373458,6268,27926,4.45532865347798
"6269",2006-01-26,2,6,-121.3815598,38.63862878,6269,27932,4.4555750518424
"6270",2006-01-26,4,3,-121.5238205,38.52474322,6270,27935,4.45534290271132
"6271",2006-01-26,4,5,-121.4762318,38.50773512,6271,27940,4.45542975601977
"6272",2006-01-26,2,8,-121.4307875,38.6247477,6272,27948,4.45599489795918
"6273",2006-01-26,4,4,-121.4918953,38.56268259,6273,27952,4.45592220628089
"6274",2006-01-26,3,8,-121.4090347,38.56536191,6274,27960,4.45648708957603
"6275",2006-01-26,2,1,-121.4305962,38.63292418,6275,27961,4.45593625498008
"6276",2006-01-26,3,3,-121.3940644,38.54818818,6276,27964,4.45570427023582
"6277",2006-01-26,2,1,-121.4427075,38.61564793,6277,27965,4.45515373586108
"6278",2006-01-26,1,8,-121.501905,38.61675238,6278,27973,4.45571838165021
"6279",2006-01-26,1,5,-121.5091329,38.65024515,6279,27978,4.45580506450072
"6280",2006-01-26,4,1,-121.4827348,38.49575914,6280,27979,4.45525477707006
"6281",2006-01-26,2,5,-121.3829415,38.63715334,6281,27984,4.4553415061296
"6282",2006-01-26,6,5,-121.4535315,38.54276722,6282,27989,4.4554282075772
"6283",2006-01-26,4,7,-121.4882773,38.55317669,6283,27996,4.4558332007003
"6284",2006-01-26,3,4,-121.4854695,38.56623766,6284,28000,4.45576066199873
"6285",2006-01-26,2,1,-121.4487064,38.61112661,6285,28001,4.4552108194113
"6286",2006-01-26,2,1,-121.4291698,38.64011428,6286,28002,4.45466115176583
"6287",2006-01-26,2,1,-121.4528434,38.60880668,6287,28003,4.45411165897884
"6288",2006-01-26,4,7,-121.4972545,38.56201402,6288,28010,4.4545165394402
"6289",2006-01-26,6,5,-121.421399,38.51698304,6289,28015,4.4546032755605
"6290",2006-01-26,5,7,-121.487144,38.48072279,6290,28022,4.4550079491256
"6291",2006-01-26,2,1,-121.4634269,38.60407552,6291,28023,4.45445875059609
"6292",2006-01-26,4,4,-121.4933036,38.53527057,6292,28027,4.45438652256834
"6293",2006-01-26,6,3,-121.4101636,38.53499467,6293,28030,4.45415541077388
"6294",2006-01-26,5,7,-121.4245504,38.44383839,6294,28037,4.45455989831586
"6295",2006-01-26,5,2,-121.4347565,38.4702938,6295,28039,4.45416997617156
"6296",2006-01-26,6,7,-121.4320057,38.51491299,6296,28046,4.45457433290978
"6297",2006-01-26,3,7,-121.4918433,38.58079457,6297,28053,4.45497856121963
"6298",2006-01-26,2,2,-121.4280845,38.62352342,6298,28055,4.45458875833598
"6299",2006-01-26,1,4,-121.5300525,38.61401423,6299,28059,4.45451658993491
"6300",2006-01-26,3,7,-121.4879497,38.58615671,6300,28066,4.45492063492063
"6301",2006-01-26,5,8,-121.4854238,38.47849643,6301,28074,4.45548325662593
"6302",2006-01-26,4,5,-121.5121112,38.49549964,6302,28079,4.45556966042526
"6303",2006-01-26,6,7,-121.4363269,38.51828144,6303,28086,4.4559733460257
"6304",2006-01-26,1,5,-121.4912285,38.63069377,6304,28091,4.45605964467005
"6305",2006-01-26,2,7,-121.4464214,38.62732227,6305,28098,4.45646312450436
"6306",2006-01-26,2,7,-121.42747,38.60154457,6306,28105,4.45686647637171
"6307",2006-01-26,4,7,-121.500048,38.54016571,6307,28112,4.45726970033296
"6308",2006-01-26,4,5,-121.4813727,38.54619323,6308,28117,4.45735573874445
"6309",2006-01-26,2,3,-121.4408887,38.64004786,6309,28120,4.45712474243145
"6310",2006-01-26,1,7,-121.4984478,38.6270814,6310,28127,4.45752773375594
"6311",2006-01-26,1,7,-121.4921059,38.61465862,6311,28134,4.45793059736967
"6312",2006-01-26,1,5,-121.4968142,38.60956898,6312,28139,4.4580164765526
"6313",2006-01-26,4,8,-121.4984736,38.56321928,6313,28147,4.4585775384128
"6314",2006-01-26,5,5,-121.4638829,38.48616681,6314,28152,4.45866328793158
"6315",2006-01-26,6,7,-121.4722717,38.55464254,6315,28159,4.4590657165479
"6316",2006-01-26,2,6,-121.459947,38.61812954,6316,28165,4.45930968967701
"6317",2006-01-26,3,7,-121.4893746,38.58357633,6317,28172,4.45971188855469
"6318",2006-01-26,5,7,-121.4237492,38.4726202,6318,28179,4.46011396011396
"6319",2006-01-26,1,7,-121.4767011,38.60870001,6319,28186,4.46051590441526
"6320",2006-01-26,4,3,-121.4735075,38.52933607,6320,28189,4.46028481012658
"6321",2006-01-26,6,5,-121.4718056,38.54911008,6321,28194,4.46037019458946
"6322",2006-01-26,2,5,-121.4511933,38.64450436,6322,28199,4.46045555204049
"6323",2006-01-26,6,7,-121.4665115,38.55426465,6323,28206,4.46085718804365
"6324",2006-01-26,5,3,-121.4966972,38.48136888,6324,28209,4.46062618595825
"6325",2006-01-26,5,3,-121.4966972,38.48136888,6325,28212,4.460395256917
"6326",2006-01-26,4,6,-121.479014,38.53881527,6326,28218,4.46063863420803
"6327",2006-01-26,1,7,-121.5120524,38.65599922,6327,28225,4.46103998735578
"6328",2006-01-26,3,3,-121.465437,38.56326638,6328,28228,4.46080910240202
"6329",2006-01-26,1,3,-121.4802044,38.61154684,6329,28231,4.46057829040923
"6330",2006-01-26,5,2,-121.4194843,38.44511463,6330,28233,4.46018957345972
"6331",2006-01-26,5,5,-121.4394172,38.46257018,6331,28238,4.46027483809825
"6332",2006-01-26,6,3,-121.4691287,38.53809209,6332,28241,4.46004421983575
"6333",2006-01-26,1,5,-121.5236456,38.62848932,6333,28246,4.46012948049897
"6334",2006-01-26,6,1,-121.4711664,38.55468143,6334,28247,4.45958320176824
"6335",2006-01-26,1,5,-121.4863638,38.62906044,6335,28252,4.45966850828729
"6336",2006-01-26,6,7,-121.4243203,38.54783739,6336,28259,4.46006944444444
"6337",2006-01-26,1,4,-121.5119979,38.65731154,6337,28263,4.45999684393246
"6338",2006-01-26,5,4,-121.4420842,38.47390737,6338,28267,4.45992426633007
"6339",2006-01-26,2,2,-121.4639783,38.61312045,6339,28269,4.45953620444865
"6340",2006-01-26,3,5,-121.482936,38.57993959,6340,28274,4.4596214511041
"6341",2006-01-26,6,4,-121.4091587,38.53519,6341,28278,4.4595489670399
"6342",2006-01-26,1,4,-121.4936544,38.67801954,6342,28282,4.45947650583412
"6343",2006-01-26,1,5,-121.501014,38.61354404,6343,28287,4.45956172158285
"6344",2006-01-26,1,6,-121.4940089,38.62514818,6344,28293,4.45980453972257
"6345",2006-01-26,2,4,-121.442841,38.63573789,6345,28297,4.45973207249803
"6346",2006-01-26,3,4,-121.4842662,38.58029426,6346,28301,4.4596596281122
"6347",2006-01-26,5,8,-121.4311763,38.47994748,6347,28309,4.46021742555538
"6348",2006-01-26,3,5,-121.4739507,38.56312416,6348,28314,4.46030245746692
"6349",2006-01-26,4,9,-121.5128785,38.51876369,6349,28323,4.4610174830682
"6350",2006-01-26,6,5,-121.4274484,38.51052171,6350,28328,4.46110236220472
"6351",2006-01-26,6,7,-121.466281,38.54394982,6351,28335,4.4615021256495
"6352",2006-01-26,5,5,-121.4211836,38.4689635,6352,28340,4.46158690176322
"6353",2006-01-26,1,5,-121.5077537,38.66183536,6353,28345,4.46167165118842
"6354",2006-01-26,2,5,-121.4315006,38.60468382,6354,28350,4.46175637393768
"6355",2006-01-26,6,7,-121.4243203,38.54783739,6355,28357,4.46215578284815
"6356",2006-01-26,5,5,-121.4232391,38.44408174,6356,28362,4.46224040276904
"6357",2006-01-26,5,5,-121.4398868,38.45300832,6357,28367,4.46232499606733
"6358",2006-01-26,3,5,-121.4765423,38.56263065,6358,28372,4.46240956275558
"6359",2006-01-26,3,7,-121.4071828,38.55125471,6359,28379,4.46280861770719
"6360",2006-01-26,1,5,-121.5219811,38.65588957,6360,28384,4.46289308176101
"6361",2006-01-26,6,5,-121.4367887,38.52796591,6361,28389,4.46297751925798
"6362",2006-01-27,1,3,-121.5089847,38.61737298,6362,28392,4.46274756365923
"6363",2006-01-27,1,4,-121.4971988,38.62649659,6363,28396,4.46267483891246
"6364",2006-01-27,5,7,-121.4196769,38.46353269,6364,28403,4.46307353865493
"6365",2006-01-27,6,7,-121.4399759,38.54233994,6365,28410,4.46347211311862
"6366",2006-01-27,4,7,-121.5059335,38.5298745,6366,28417,4.46387056236255
"6367",2006-01-27,4,4,-121.4889962,38.55729053,6367,28421,4.46379770692634
"6368",2006-01-27,3,7,-121.4838724,38.56317157,6368,28428,4.4641959798995
"6369",2006-01-27,6,4,-121.4471706,38.52935875,6369,28432,4.46412309624745
"6370",2006-01-27,4,7,-121.5184395,38.53065491,6370,28439,4.46452119309262
"6371",2006-01-27,6,7,-121.434692,38.53627316,6371,28446,4.46491916496625
"6372",2006-01-27,4,7,-121.5127489,38.52187978,6372,28453,4.46531701192718
"6373",2006-01-27,2,7,-121.4386701,38.63056637,6373,28460,4.46571473403421
"6374",2006-01-27,5,7,-121.4521928,38.47211319,6374,28467,4.46611233134609
"6375",2006-01-27,4,7,-121.5475886,38.48797175,6375,28474,4.46650980392157
"6376",2006-01-27,1,4,-121.4936477,38.60996158,6376,28478,4.46643663739021
"6377",2006-01-27,3,4,-121.4489247,38.56522094,6377,28482,4.46636349380586
"6378",2006-01-27,1,4,-121.541883,38.65798545,6378,28486,4.46629037315773
"6379",2006-01-27,4,4,-121.5361031,38.4909248,6379,28490,4.46621727543502
"6380",2006-01-27,3,8,-121.4858893,38.59049989,6380,28498,4.46677115987461
"6381",2006-01-27,3,5,-121.4149051,38.55706875,6381,28503,4.46685472496474
"6382",2006-01-27,6,7,-121.4342645,38.50595853,6382,28510,4.46725164525227
"6383",2006-01-27,6,5,-121.4200034,38.53259228,6383,28515,4.46733510888297
"6384",2006-01-27,3,7,-121.4897002,38.58451688,6384,28522,4.46773182957393
"6385",2006-01-27,3,7,-121.4809519,38.5790575,6385,28529,4.46812842599843
"6386",2006-01-27,5,6,-121.4417288,38.48094352,6386,28535,4.46836830566865
"6387",2006-01-27,5,6,-121.4354515,38.44863716,6387,28541,4.46860811022389
"6388",2006-01-27,5,8,-121.4390572,38.45370726,6388,28549,4.46916092673763
"6389",2006-01-27,3,8,-121.487703,38.5766684,6389,28557,4.46971357019878
"6390",2006-01-27,1,4,-121.5102676,38.65735092,6390,28561,4.46964006259781
"6391",2006-01-27,1,4,-121.495299,38.66739173,6391,28565,4.46956657800031
"6392",2006-01-27,5,5,-121.4382695,38.47216444,6392,28570,4.46964956195244
"6393",2006-01-27,4,7,-121.5196746,38.5154256,6393,28577,4.47004536211481
"6394",2006-01-27,3,1,-121.4808391,38.56764212,6394,28578,4.46950265874257
"6395",2006-01-27,2,4,-121.4542983,38.61853144,6395,28582,4.469429241595
"6396",2006-01-27,3,3,-121.4958669,38.57476286,6396,28585,4.4691994996873
"6397",2006-01-27,3,9,-121.466838,38.57001413,6397,28594,4.46990776926684
"6398",2006-01-27,6,7,-121.4184854,38.51767414,6398,28601,4.47030321975617
"6399",2006-01-27,1,5,-121.500334,38.63365507,6399,28606,4.47038599781216
"6400",2006-01-27,1,6,-121.4926223,38.63307512,6400,28612,4.470625
"6401",2006-01-27,2,5,-121.4481351,38.64379236,6401,28617,4.47070770192158
"6402",2006-01-27,2,8,-121.4398335,38.63398247,6402,28625,4.47125898156826
"6403",2006-01-27,4,2,-121.4742028,38.53127512,6403,28627,4.470873028268
"6404",2006-01-27,5,7,-121.4483361,38.46990907,6404,28634,4.47126795752655
"6405",2006-01-27,2,1,-121.4481351,38.64379236,6405,28635,4.47072599531616
"6406",2006-01-27,5,5,-121.4272467,38.44809977,6406,28640,4.47080861692164
"6407",2006-01-27,3,5,-121.4557908,38.57110778,6407,28645,4.47089121273607
"6408",2006-01-27,3,7,-121.4061343,38.56841979,6408,28652,4.47128589263421
"6409",2006-01-27,2,6,-121.4347477,38.63475409,6409,28658,4.47152441878608
"6410",2006-01-27,5,7,-121.5010974,38.48507025,6410,28665,4.47191887675507
"6411",2006-01-27,3,2,-121.4403257,38.56148913,6411,28667,4.47153330213695
"6412",2006-01-27,4,3,-121.4990149,38.52199137,6412,28670,4.47130380536494
"6413",2006-01-27,6,7,-121.4380403,38.5514883,6413,28677,4.47169811320755
"6414",2006-01-27,3,7,-121.4892123,38.58376783,6414,28684,4.47209229809791
"6415",2006-01-27,1,7,-121.4867838,38.62032474,6415,28691,4.47248636009353
"6416",2006-01-27,5,4,-121.428879,38.45400615,6416,28695,4.47241271820449
"6417",2006-01-27,2,7,-121.45998,38.62071088,6417,28702,4.47280660744896
"6418",2006-01-27,2,6,-121.4369555,38.61364029,6418,28708,4.4730445621689
"6419",2006-01-27,1,8,-121.4732289,38.63199179,6419,28716,4.47359401775978
"6420",2006-01-27,5,3,-121.4563236,38.46447974,6420,28719,4.47336448598131
"6421",2006-01-27,4,1,-121.4883801,38.55004952,6421,28720,4.472823547734
"6422",2006-01-27,2,5,-121.463195,38.63022952,6422,28725,4.47290563687325
"6423",2006-01-27,2,7,-121.4291435,38.64733599,6423,28732,4.47329908142612
"6424",2006-01-27,5,1,-121.4891116,38.48401564,6424,28733,4.47275840597758
"6425",2006-01-27,2,4,-121.4646676,38.65602893,6425,28737,4.47268482490272
"6426",2006-01-27,1,7,-121.4952127,38.65733301,6426,28744,4.47307812013694
"6427",2006-01-27,6,7,-121.4458147,38.54100057,6427,28751,4.47347129298273
"6428",2006-01-27,4,1,-121.4746419,38.53953965,6428,28752,4.47293092719353
"6429",2006-01-27,2,2,-121.4326189,38.65369344,6429,28754,4.4725462746928
"6430",2006-01-27,2,5,-121.4575422,38.63610422,6430,28759,4.47262830482115
"6431",2006-01-27,6,5,-121.407542,38.53157904,6431,28764,4.47271030943866
"6432",2006-01-27,3,3,-121.4832354,38.59124596,6432,28767,4.47248134328358
"6433",2006-01-27,4,7,-121.4836319,38.52487561,6433,28774,4.47287424218871
"6434",2006-01-27,5,6,-121.4120435,38.44386605,6434,28780,4.4731115946534
"6435",2006-01-27,2,2,-121.4258885,38.59891162,6435,28782,4.47272727272727
"6436",2006-01-27,1,1,-121.5089523,38.61547541,6436,28783,4.47218769422001
"6437",2006-01-27,4,1,-121.4832933,38.53737362,6437,28784,4.47164828336181
"6438",2006-01-27,6,5,-121.4090255,38.51749164,6438,28789,4.4717303510407
"6439",2006-01-27,2,6,-121.3815598,38.63862878,6439,28795,4.47196769684734
"6440",2006-01-27,4,1,-121.4829606,38.53696024,6440,28796,4.47142857142857
"6441",2006-01-27,4,7,-121.500048,38.54016571,6441,28803,4.47182114578482
"6442",2006-01-27,4,3,-121.5155442,38.52716098,6442,28806,4.47159267308289
"6443",2006-01-27,4,1,-121.4745855,38.53627722,6443,28807,4.47105385689896
"6444",2006-01-27,2,5,-121.4524033,38.63831524,6444,28812,4.47113594040968
"6445",2006-01-27,3,4,-121.5014996,38.58062786,6445,28816,4.4710628394104
"6446",2006-01-27,2,7,-121.4320162,38.63748393,6446,28823,4.47145516599442
"6447",2006-01-27,5,7,-121.4499484,38.46691818,6447,28830,4.47184737087017
"6448",2006-01-27,3,1,-121.5052755,38.58245363,6448,28831,4.47130893300248
"6449",2006-01-27,5,5,-121.41229,38.44063532,6449,28836,4.47139091331989
"6450",2006-01-27,6,6,-121.4366149,38.55309324,6450,28842,4.47162790697674
"6451",2006-01-27,5,1,-121.495549,38.49406933,6451,28843,4.47108975352659
"6452",2006-01-27,1,8,-121.5031054,38.63585275,6452,28851,4.47163670179789
"6453",2006-01-27,2,4,-121.418649,38.63623413,6453,28855,4.47156361382303
"6454",2006-01-27,2,3,-121.4387656,38.63533654,6454,28858,4.47133560582584
"6455",2006-01-27,2,5,-121.4472084,38.62694709,6455,28863,4.47141750580945
"6456",2006-01-27,3,5,-121.4867244,38.56342315,6456,28868,4.47149938042131
"6457",2006-01-27,4,5,-121.5320507,38.484472,6457,28873,4.47158122967322
"6458",2006-01-27,5,5,-121.4250202,38.45879792,6458,28878,4.47166305357696
"6459",2006-01-27,1,5,-121.5379286,38.61164049,6459,28883,4.47174485214429
"6460",2006-01-27,6,6,-121.4132581,38.52472132,6460,28889,4.47198142414861
"6461",2006-01-27,6,3,-121.4084001,38.52547643,6461,28892,4.47175359851416
"6462",2006-01-27,4,1,-121.4797003,38.55497273,6462,28893,4.47121634168988
"6463",2006-01-27,5,6,-121.4859396,38.48934244,6463,28899,4.47145288565682
"6464",2006-01-27,2,5,-121.464146,38.606174,6464,28904,4.47153465346535
"6465",2006-01-27,5,3,-121.4847037,38.49502927,6465,28907,4.47130703789636
"6466",2006-01-27,3,5,-121.4976159,38.58270622,6466,28912,4.47138880296938
"6467",2006-01-27,2,5,-121.4497539,38.61642852,6467,28917,4.47147054275553
"6468",2006-01-27,3,6,-121.4812236,38.57633475,6468,28923,4.47170686456401
"6469",2006-01-27,4,7,-121.5016007,38.52859553,6469,28930,4.47209769670737
"6470",2006-01-27,6,6,-121.4122246,38.50675753,6470,28936,4.47233384853168
"6471",2006-01-27,5,5,-121.4859358,38.48745321,6471,28941,4.4724153917478
"6472",2006-01-27,2,6,-121.4430645,38.63402001,6472,28947,4.47265142150803
"6473",2006-01-27,2,5,-121.446116,38.62968232,6473,28952,4.4727328904681
"6474",2006-01-27,6,7,-121.4645183,38.53748322,6474,28959,4.47312326227989
"6475",2006-01-27,4,4,-121.504374,38.5425266,6475,28963,4.47305019305019
"6476",2006-01-27,6,2,-121.4425904,38.52497346,6476,28965,4.47266831377393
"6477",2006-01-27,3,2,-121.4890469,38.58243257,6477,28967,4.47228655241624
"6478",2006-01-27,3,5,-121.4757152,38.56572433,6478,28972,4.47236801481939
"6479",2006-01-27,1,7,-121.4706061,38.61747853,6479,28979,4.47275814168853
"6480",2006-01-27,3,3,-121.4403257,38.56148913,6480,28982,4.47253086419753
"6481",2006-01-27,6,5,-121.4718639,38.53744558,6481,28987,4.4726122511958
"6482",2006-01-27,5,8,-121.4573698,38.48078458,6482,28995,4.47315643319963
"6483",2006-01-27,2,2,-121.4575422,38.63610422,6483,28997,4.47277494986889
"6484",2006-01-27,6,3,-121.4421623,38.52563317,6484,29000,4.47254780999383
"6485",2006-01-27,3,1,-121.4790384,38.5752348,6485,29001,4.47201233616037
"6486",2006-01-27,2,2,-121.4286413,38.60034763,6486,29003,4.47163120567376
"6487",2006-01-27,4,7,-121.5469337,38.49923025,6487,29010,4.47202096500694
"6488",2006-01-27,6,6,-121.4402677,38.51181739,6488,29016,4.47225647348952
"6489",2006-01-27,1,3,-121.5004471,38.65799,6489,29019,4.47202958853444
"6490",2006-01-27,3,1,-121.4888995,38.58396965,6490,29020,4.47149460708783
"6491",2006-01-27,6,5,-121.464048,38.55169404,6491,29025,4.47157602834694
"6492",2006-01-27,2,2,-121.4575422,38.63610422,6492,29027,4.47119531731362
"6493",2006-01-27,1,5,-121.5194346,38.64299789,6493,29032,4.47127675958725
"6494",2006-01-27,3,3,-121.5027369,38.582786,6494,29035,4.47105020018479
"6495",2006-01-27,3,1,-121.4679136,38.58196942,6495,29036,4.47051578137028
"6496",2006-01-27,3,3,-121.4779775,38.56389477,6496,29039,4.47028940886699
"6497",2006-01-27,3,2,-121.4864165,38.59308341,6497,29041,4.46990918885639
"6498",2006-01-27,2,7,-121.4244182,38.61199425,6498,29048,4.47029855340105
"6499",2006-01-27,1,4,-121.5006047,38.65798793,6499,29052,4.47022618864441
"6500",2006-01-27,3,1,-121.5014996,38.58062786,6500,29053,4.46969230769231
"6501",2006-01-27,1,3,-121.4939291,38.63293804,6501,29056,4.4694662359637
"6502",2006-01-27,3,8,-121.4063599,38.54888073,6502,29064,4.47000922792987
"6503",2006-01-27,2,5,-121.4550081,38.62229397,6503,29069,4.47009072735661
"6504",2006-01-27,4,7,-121.4775822,38.51374661,6504,29076,4.47047970479705
"6505",2006-01-27,6,6,-121.4256917,38.52862804,6505,29082,4.47071483474251
"6506",2006-01-27,2,7,-121.4553219,38.64628124,6506,29089,4.47110359667999
"6507",2006-01-27,4,7,-121.5101062,38.51426513,6507,29096,4.47149223912709
"6508",2006-01-27,3,2,-121.4879497,38.58615671,6508,29098,4.47111247695144
"6509",2006-01-27,4,1,-121.5470994,38.51056884,6509,29099,4.47057919803349
"6510",2006-01-27,6,6,-121.427662,38.5379356,6510,29105,4.47081413210445
"6511",2006-01-27,6,7,-121.421048,38.51846135,6511,29112,4.47120258024881
"6512",2006-01-27,5,7,-121.4270962,38.47731868,6512,29119,4.47159090909091
"6513",2006-01-27,5,7,-121.4792548,38.49478793,6513,29126,4.47197911868571
"6514",2006-01-27,6,2,-121.4328824,38.51058143,6514,29128,4.47159963156279
"6515",2006-01-27,5,7,-121.4772322,38.48709291,6515,29135,4.47198772064467
"6516",2006-01-27,6,5,-121.4451097,38.53544489,6516,29140,4.47206875383671
"6517",2006-01-27,3,5,-121.4858893,38.59049989,6517,29145,4.4721497621605
"6518",2006-01-27,5,5,-121.4837664,38.4801723,6518,29150,4.47223074562749
"6519",2006-01-27,4,7,-121.5153055,38.53555705,6519,29157,4.4726184997699
"6520",2006-01-27,6,5,-121.4618436,38.54539286,6520,29162,4.47269938650307
"6521",2006-01-27,1,4,-121.4893334,38.62011633,6521,29166,4.47262689771507
"6522",2006-01-27,2,3,-121.4213663,38.63486377,6522,29169,4.47240110395584
"6523",2006-01-27,3,3,-121.5023171,38.56673694,6523,29172,4.47217537942664
"6524",2006-01-27,2,7,-121.4427536,38.6348368,6524,29179,4.47256284488044
"6525",2006-01-27,2,1,-121.4327805,38.63031252,6525,29180,4.472030651341
"6526",2006-01-27,3,3,-121.4436785,38.56342471,6526,29183,4.47180508734294
"6527",2006-01-27,6,4,-121.4254625,38.54146972,6527,29187,4.47173280220622
"6528",2006-01-27,4,3,-121.4764341,38.55735796,6528,29190,4.47150735294118
"6529",2006-01-27,3,4,-121.4648897,38.57188611,6529,29194,4.47143513554909
"6530",2006-01-27,3,3,-121.3870109,38.5490874,6530,29197,4.47120980091884
"6531",2006-01-27,2,7,-121.4528434,38.60880668,6531,29204,4.47159699892819
"6532",2006-01-27,2,7,-121.4569973,38.6060748,6532,29211,4.47198407838334
"6533",2006-01-27,6,1,-121.4190115,38.53720874,6533,29212,4.47145262513394
"6534",2006-01-27,3,7,-121.4692575,38.57201606,6534,29219,4.47183960820324
"6535",2006-01-27,4,7,-121.4877457,38.5609783,6535,29226,4.47222647283856
"6536",2006-01-27,3,3,-121.4974852,38.58239537,6536,29229,4.47200122399021
"6537",2006-01-27,3,3,-121.4879903,38.57514018,6537,29232,4.47177604405691
"6538",2006-01-27,5,3,-121.450353,38.46971274,6538,29235,4.47155093300704
"6539",2006-01-27,2,3,-121.455492,38.60613913,6539,29238,4.47132589080899
"6540",2006-01-27,4,5,-121.5218221,38.49171786,6540,29243,4.47140672782875
"6541",2006-01-27,4,5,-121.5218221,38.49171786,6541,29248,4.47148754013148
"6542",2006-01-27,4,7,-121.4766477,38.55827881,6542,29255,4.47187404463467
"6543",2006-01-27,3,7,-121.5047063,38.5813034,6543,29262,4.47226043099496
"6544",2006-01-27,4,1,-121.5423774,38.50901528,6544,29263,4.47172982885086
"6545",2006-01-27,4,4,-121.5212433,38.49466185,6545,29267,4.4716577540107
"6546",2006-01-27,6,4,-121.3805279,38.5128419,6546,29271,4.47158570119157
"6547",2006-01-27,4,6,-121.5108328,38.5535955,6547,29277,4.47181915381091
"6548",2006-01-27,5,3,-121.4271656,38.47650897,6548,29280,4.47159437996335
"6549",2006-01-27,6,6,-121.4560574,38.5448578,6549,29286,4.47182775996335
"6550",2006-01-27,6,3,-121.4120841,38.52084905,6550,29289,4.47160305343511
"6551",2006-01-27,1,5,-121.5096933,38.62680826,6551,29294,4.47168371241032
"6552",2006-01-27,5,7,-121.4272581,38.46541304,6552,29301,4.4720695970696
"6553",2006-01-27,1,6,-121.4959999,38.63020663,6553,29307,4.4723027620937
"6554",2006-01-27,4,5,-121.4725037,38.52940564,6554,29312,4.47238327738785
"6555",2006-01-27,1,3,-121.5120524,38.65599922,6555,29315,4.47215865751335
"6556",2006-01-27,3,7,-121.4693168,38.57015733,6556,29322,4.4725442342892
"6557",2006-01-27,1,4,-121.4806917,38.62296938,6557,29326,4.47247216714961
"6558",2006-01-27,1,4,-121.541883,38.65798545,6558,29330,4.47240012198841
"6559",2006-01-27,5,7,-121.4281268,38.47295223,6559,29337,4.47278548559232
"6560",2006-01-27,1,5,-121.4898419,38.62584659,6560,29342,4.47286585365854
"6561",2006-01-27,3,2,-121.4672451,38.57216608,6561,29344,4.47248894985521
"6562",2006-01-27,2,2,-121.3829415,38.63715334,6562,29346,4.47211216092655
"6563",2006-01-27,2,2,-121.4415307,38.62379772,6563,29348,4.47173548682005
"6564",2006-01-27,5,2,-121.4217163,38.47521595,6564,29350,4.47135892748324
"6565",2006-01-27,1,5,-121.4935049,38.66258951,6565,29355,4.47143945163747
"6566",2006-01-27,4,3,-121.5184681,38.48651138,6566,29358,4.47121535181237
"6567",2006-01-27,3,4,-121.4707544,38.56684956,6567,29362,4.47114359677174
"6568",2006-01-27,6,5,-121.4351262,38.5149777,6568,29367,4.47122411693057
"6569",2006-01-27,3,6,-121.4894043,38.59214104,6569,29373,4.47145684274623
"6570",2006-01-27,6,1,-121.370871,38.52478964,6570,29374,4.47092846270928
"6571",2006-01-27,5,2,-121.4703481,38.4967273,6571,29376,4.47055242733222
"6572",2006-01-27,6,5,-121.4107732,38.5242556,6572,29381,4.47063298843579
"6573",2006-01-27,6,5,-121.4703448,38.53297648,6573,29386,4.47071352502662
"6574",2006-01-27,5,6,-121.4811463,38.48740985,6574,29392,4.47094615150593
"6575",2006-01-27,6,4,-121.4425904,38.52497346,6575,29396,4.47087452471483
"6576",2006-01-27,5,6,-121.4484859,38.47177154,6576,29402,4.47110705596107
"6577",2006-01-27,3,7,-121.4109174,38.55549156,6577,29409,4.47149156150221
"6578",2006-01-27,2,4,-121.4652253,38.60130769,6578,29413,4.47141988446336
"6579",2006-01-27,3,1,-121.4648897,38.57188611,6579,29414,4.47089223286214
"6580",2006-01-27,1,5,-121.4939815,38.61223942,6580,29419,4.4709726443769
"6581",2006-01-27,5,7,-121.4947044,38.49097097,6581,29426,4.47135693663577
"6582",2006-01-27,4,1,-121.4787326,38.50457486,6582,29427,4.47082953509572
"6583",2006-01-27,5,7,-121.4487485,38.47531506,6583,29434,4.47121373234088
"6584",2006-01-27,6,3,-121.4403427,38.52498732,6584,29437,4.47099027946537
"6585",2006-01-27,4,7,-121.4771985,38.51031519,6585,29444,4.47137433561124
"6586",2006-01-27,2,1,-121.4382061,38.63258514,6586,29445,4.47084725174613
"6587",2006-01-27,5,1,-121.4200444,38.43891434,6587,29446,4.47032032791863
"6588",2006-01-27,4,7,-121.5193356,38.51542968,6588,29453,4.47070431086825
"6589",2006-01-27,1,7,-121.5078403,38.64727956,6589,29460,4.47108817726514
"6590",2006-01-27,5,7,-121.4342202,38.47846862,6590,29467,4.47147192716237
"6591",2006-01-27,3,2,-121.4739148,38.58364167,6591,29469,4.47109695038689
"6592",2006-01-27,3,4,-121.4648897,38.57188611,6592,29473,4.47102548543689
"6593",2006-01-27,4,7,-121.5436794,38.50105448,6593,29480,4.471409070226
"6594",2006-01-27,2,7,-121.4581238,38.64479784,6594,29487,4.47179253867152
"6595",2006-01-27,2,4,-121.4174243,38.63486324,6595,29491,4.47172100075815
"6596",2006-01-27,6,7,-121.4146606,38.53699185,6596,29498,4.47210430563978
"6597",2006-01-27,5,7,-121.4730323,38.49521557,6597,29505,4.4724874943156
"6598",2006-01-27,6,1,-121.4120436,38.52703823,6598,29506,4.47196120036375
"6599",2006-01-27,2,5,-121.4611955,38.62428352,6599,29511,4.47204121836642
"6600",2006-01-27,5,5,-121.4303627,38.47902907,6600,29516,4.47212121212121
"6601",2006-01-27,2,6,-121.4549497,38.62260674,6601,29522,4.4723526738373
"6602",2006-01-27,4,4,-121.47238,38.49742308,6602,29526,4.47228112693123
"6603",2006-01-27,2,4,-121.42747,38.60154457,6603,29530,4.4722096016962
"6604",2006-01-27,3,2,-121.4692124,38.5738419,6604,29532,4.47183525136281
"6605",2006-01-27,5,2,-121.427181,38.46849636,6605,29534,4.47146101438304
"6606",2006-01-27,2,3,-121.4570278,38.62642786,6606,29537,4.47123826824099
"6607",2006-01-27,6,6,-121.4176327,38.53522747,6607,29543,4.47146965339791
"6608",2006-01-27,2,4,-121.450154,38.65213863,6608,29547,4.47139830508475
"6609",2006-01-27,2,8,-121.4362525,38.62596616,6609,29555,4.47193221364806
"6610",2006-01-27,6,5,-121.4350231,38.5500869,6610,29560,4.47201210287443
"6611",2006-01-27,6,7,-121.438141,38.5173841,6611,29567,4.47239449402511
"6612",2006-01-27,3,5,-121.4809362,38.58794604,6612,29572,4.4724742891712
"6613",2006-01-27,2,4,-121.424815,38.63483426,6613,29576,4.47240284288523
"6614",2006-01-27,3,8,-121.5046032,38.58203886,6614,29584,4.47293619594799
"6615",2006-01-27,5,2,-121.4200444,38.43891434,6615,29586,4.47256235827664
"6616",2006-01-27,6,7,-121.4546045,38.55426406,6616,29593,4.47294437726723
"6617",2006-01-27,1,4,-121.5248005,38.67684158,6617,29597,4.47287290312831
"6618",2006-01-27,1,6,-121.481537,38.62080937,6618,29603,4.47310365669387
"6619",2006-01-27,4,5,-121.473755,38.51852642,6619,29608,4.47318326031123
"6620",2006-01-27,3,5,-121.4735232,38.56322381,6620,29613,4.47326283987915
"6621",2006-01-27,3,3,-121.4669217,38.57566567,6621,29616,4.47304032623471
"6622",2006-01-27,4,5,-121.518673,38.48254436,6622,29621,4.47311990335246
"6623",2006-01-27,6,1,-121.4341752,38.54677938,6623,29622,4.47259550052846
"6624",2006-01-27,4,6,-121.481424,38.53384496,6624,29628,4.47282608695652
"6625",2006-01-27,3,3,-121.4682622,38.57602331,6625,29631,4.47260377358491
"6626",2006-01-27,5,3,-121.4512042,38.47484895,6626,29634,4.47238152731663
"6627",2006-01-27,5,3,-121.444828,38.45210678,6627,29637,4.47215934812132
"6628",2006-01-27,1,2,-121.4837251,38.61735652,6628,29639,4.47178636089318
"6629",2006-01-27,1,1,-121.5282155,38.63087775,6629,29640,4.47126263388143
"6630",2006-01-27,1,7,-121.4956821,38.62415595,6630,29647,4.47164404223228
"6631",2006-01-27,2,5,-121.4385127,38.61677548,6631,29652,4.47172372191223
"6632",2006-01-27,1,6,-121.5279355,38.62663415,6632,29658,4.47195416164053
"6633",2006-01-27,4,4,-121.489931,38.54735161,6633,29662,4.47188300919644
"6634",2006-01-27,6,3,-121.4725708,38.53736094,6634,29665,4.47166113958396
"6635",2006-01-27,2,1,-121.45769,38.63095078,6635,29666,4.47113790504898
"6636",2006-01-27,2,3,-121.4516169,38.61357608,6636,29669,4.4709162145871
"6637",2006-01-27,4,3,-121.5235515,38.49590431,6637,29672,4.47069459092964
"6638",2006-01-27,5,5,-121.460842,38.49515388,6638,29677,4.47077432961735
"6639",2006-01-27,4,7,-121.4736999,38.53122066,6639,29684,4.47115529447206
"6640",2006-01-27,4,2,-121.513317,38.5672313,6640,29686,4.47078313253012
"6641",2006-01-28,4,7,-121.4920163,38.54716857,6641,29693,4.47116398132811
"6642",2006-01-28,4,7,-121.5140712,38.47704147,6642,29700,4.47154471544715
"6643",2006-01-28,6,7,-121.4443318,38.55498681,6643,29707,4.47192533493903
"6644",2006-01-28,3,7,-121.4943412,38.58175835,6644,29714,4.47230583985551
"6645",2006-01-28,3,5,-121.4673942,38.56203149,6645,29719,4.47238525206923
"6646",2006-01-28,2,5,-121.4468253,38.66188461,6646,29724,4.47246464038519
"6647",2006-01-28,6,5,-121.4222989,38.52412152,6647,29729,4.4725440048142
"6648",2006-01-28,5,4,-121.4380731,38.45583883,6648,29733,4.47247292418773
"6649",2006-01-28,5,4,-121.4558673,38.47623848,6649,29737,4.4724018649421
"6650",2006-01-28,6,4,-121.4418944,38.55453847,6650,29741,4.47233082706767
"6651",2006-01-28,3,7,-121.3868967,38.55627023,6651,29748,4.47271087054578
"6652",2006-01-28,3,7,-121.4657994,38.56718102,6652,29755,4.47309079975947
"6653",2006-01-28,2,7,-121.4170313,38.64310734,6653,29762,4.47347061476026
"6654",2006-01-28,5,7,-121.4605802,38.47059568,6654,29769,4.47385031559964
"6655",2006-01-28,4,9,-121.4758443,38.55720151,6655,29778,4.47453042824944
"6656",2006-01-28,2,2,-121.4486547,38.60605186,6656,29780,4.47415865384615
"6657",2006-01-28,6,7,-121.4728456,38.54417762,6657,29787,4.47453808021631
"6658",2006-01-28,3,3,-121.485061,38.59279731,6658,29790,4.47431661159507
"6659",2006-01-28,3,1,-121.5054395,38.58352799,6659,29791,4.47379486409371
"6660",2006-01-28,1,5,-121.491621,38.61149042,6660,29796,4.47387387387387
"6661",2006-01-28,2,4,-121.4485207,38.61975623,6661,29800,4.47380273232247
"6662",2006-01-28,6,3,-121.4274961,38.52201375,6662,29803,4.47358150705494
"6663",2006-01-28,4,6,-121.4797946,38.50654024,6663,29809,4.4738105958277
"6664",2006-01-28,5,9,-121.4279312,38.4746867,6664,29818,4.47448979591837
"6665",2006-01-28,5,6,-121.4800191,38.48530689,6665,29824,4.47471867966992
"6666",2006-01-28,5,1,-121.4272922,38.44546938,6666,29825,4.47419741974197
"6667",2006-01-28,6,7,-121.4688287,38.54176204,6667,29832,4.47457627118644
"6668",2006-01-28,6,7,-121.4431889,38.52532233,6668,29839,4.4749550089982
"6669",2006-01-28,2,7,-121.4265496,38.64071644,6669,29846,4.47533363322837
"6670",2006-01-28,5,6,-121.4803322,38.47732859,6670,29852,4.47556221889055
"6671",2006-01-28,1,9,-121.4853777,38.61242942,6671,29861,4.47624044371159
"6672",2006-01-28,5,5,-121.4256049,38.4742413,6672,29866,4.47631894484412
"6673",2006-01-28,5,5,-121.4341919,38.47895451,6673,29871,4.47639742244867
"6674",2006-01-28,6,5,-121.4177784,38.52379405,6674,29876,4.47647587653581
"6675",2006-01-28,3,4,-121.5012154,38.57523636,6675,29880,4.47640449438202
"6676",2006-01-28,5,8,-121.4338966,38.47081133,6676,29888,4.4769322947873
"6677",2006-01-28,4,7,-121.5199334,38.52215421,6677,29895,4.47731016923768
"6678",2006-01-28,1,5,-121.4821257,38.61156094,6678,29900,4.47738843965259
"6679",2006-01-28,4,4,-121.5049581,38.52535327,6679,29904,4.47731696361731
"6680",2006-01-28,1,6,-121.5062227,38.66394046,6680,29910,4.47754491017964
"6681",2006-01-28,3,3,-121.4821859,38.57484527,6681,29913,4.47732375392905
"6682",2006-01-28,6,3,-121.4465807,38.53916445,6682,29916,4.47710266387309
"6683",2006-01-28,2,7,-121.4252094,38.63627784,6683,29923,4.47748017357474
"6684",2006-01-28,5,5,-121.5003573,38.48249686,6684,29928,4.47755834829443
"6685",2006-01-28,3,4,-121.4821859,38.57484527,6685,29932,4.47748691099476
"6686",2006-01-28,5,4,-121.4394173,38.45543072,6686,29936,4.47741549506431
"6687",2006-01-28,5,7,-121.4303531,38.44430924,6687,29943,4.47779273216689
"6688",2006-01-28,3,4,-121.4884455,38.56825264,6688,29947,4.47772129186603
"6689",2006-01-28,3,7,-121.5069638,38.58113729,6689,29954,4.47809837045896
"6690",2006-01-28,4,7,-121.5398814,38.50642969,6690,29961,4.47847533632287
"6691",2006-01-28,3,3,-121.4739085,38.56646578,6691,29964,4.47825437154386
"6692",2006-01-28,3,5,-121.499643,38.57949676,6692,29969,4.47833233711895
"6693",2006-01-28,5,5,-121.4949736,38.47415053,6693,29974,4.47841027939638
"6694",2006-01-28,1,4,-121.5223763,38.65543537,6694,29978,4.47833881087541
"6695",2006-01-28,1,1,-121.5171426,38.61437028,6695,29979,4.47781926811053
"6696",2006-01-28,4,9,-121.4943972,38.53437468,6696,29988,4.47849462365591
"6697",2006-01-28,4,7,-121.5035129,38.5537181,6697,29995,4.4788711363297
"6698",2006-01-28,3,5,-121.3870109,38.5490874,6698,30000,4.47894893998208
"6699",2006-01-28,5,2,-121.4623688,38.48216993,6699,30002,4.478578892372
"6700",2006-01-28,3,3,-121.5053446,38.5699709,6700,30005,4.47835820895522
"6701",2006-01-28,1,7,-121.5135763,38.67232741,6701,30012,4.47873451723623
"6702",2006-01-28,4,5,-121.5148695,38.48808074,6702,30017,4.47881229483736
"6703",2006-01-28,2,3,-121.4396171,38.6134143,6703,30020,4.47859167536924
"6704",2006-01-28,6,5,-121.4311783,38.52619478,6704,30025,4.47866945107399
"6705",2006-01-28,4,4,-121.4827348,38.49575914,6705,30029,4.4785980611484
"6706",2006-01-28,1,7,-121.497905,38.62911104,6706,30036,4.47897405308679
"6707",2006-01-28,3,3,-121.4634062,38.57798348,6707,30039,4.47875354107649
"6708",2006-01-28,3,5,-121.408095,38.55005116,6708,30044,4.47883124627311
"6709",2006-01-28,4,5,-121.4818397,38.51848054,6709,30049,4.47890892830526
"6710",2006-01-28,2,4,-121.4192897,38.64481568,6710,30053,4.47883755588674
"6711",2006-01-28,6,1,-121.4476033,38.5249316,6711,30054,4.47831917746983
"6712",2006-01-28,4,3,-121.4712477,38.52718667,6712,30057,4.4780989272944
"6713",2006-01-28,5,2,-121.4596812,38.46985008,6713,30059,4.4777297780426
"6714",2006-01-28,2,1,-121.429335,38.6382863,6714,30060,4.47721179624665
"6715",2006-01-28,3,7,-121.43886,38.5730919,6715,30067,4.47758749069248
"6716",2006-01-28,1,7,-121.5227128,38.60468375,6716,30074,4.47796307325789
"6717",2006-01-28,3,5,-121.4819129,38.56859703,6717,30079,4.47804079202025
"6718",2006-01-28,4,2,-121.4712477,38.52718667,6718,30081,4.4776719261685
"6719",2006-01-28,2,6,-121.459947,38.61812954,6719,30087,4.47789849680012
"6720",2006-01-28,5,5,-121.4706699,38.49856307,6720,30092,4.47797619047619
"6721",2006-01-28,2,5,-121.4427258,38.61286363,6721,30097,4.47805386103258
"6722",2006-01-28,5,5,-121.5029365,38.48285946,6722,30102,4.47813150847962
"6723",2006-01-28,2,3,-121.4303283,38.63228581,6723,30105,4.47791164658635
"6724",2006-01-28,2,8,-121.4430247,38.65658596,6724,30113,4.47843545508626
"6725",2006-01-28,1,5,-121.5341593,38.64378844,6725,30118,4.47851301115242
"6726",2006-01-28,5,5,-121.4375984,38.47489614,6726,30123,4.478590544157
"6727",2006-01-28,6,1,-121.4397584,38.51881709,6727,30124,4.47807343540954
"6728",2006-01-28,2,2,-121.449322,38.61661868,6728,30126,4.47770511296076
"6729",2006-01-28,2,2,-121.4276508,38.59994183,6729,30128,4.47733689998514
"6730",2006-01-28,5,7,-121.4704421,38.49347928,6730,30135,4.4777117384844
"6731",2006-01-28,6,6,-121.4517155,38.54066622,6731,30141,4.47793789927202
"6732",2006-01-28,1,2,-121.4862116,38.63075126,6732,30143,4.47756981580511
"6733",2006-01-28,6,1,-121.4572213,38.55136292,6733,30144,4.47705331947126
"6734",2006-01-28,6,6,-121.4622826,38.55952278,6734,30150,4.47727947727948
"6735",2006-01-28,4,4,-121.4836969,38.52555689,6735,30154,4.47720861172977
"6736",2006-01-28,2,4,-121.4295032,38.60240036,6736,30158,4.4771377672209
"6737",2006-01-28,2,2,-121.4476543,38.61140992,6737,30160,4.47677007570135
"6738",2006-01-28,4,1,-121.4880681,38.51018807,6738,30161,4.47625408132977
"6739",2006-01-28,2,2,-121.457861,38.62042639,6739,30163,4.47588663006381
"6740",2006-01-28,1,4,-121.4932977,38.61292566,6740,30167,4.47581602373887
"6741",2006-01-28,4,2,-121.4753525,38.54085269,6741,30169,4.47544874647678
"6742",2006-01-28,3,1,-121.5052755,38.58245363,6742,30170,4.47493325422723
"6743",2006-01-28,4,2,-121.4790449,38.55805348,6743,30172,4.47456621681744
"6744",2006-01-28,2,4,-121.4488234,38.63221601,6744,30176,4.47449584816133
"6745",2006-01-28,3,6,-121.411779,38.55575132,6745,30182,4.47472201630838
"6746",2006-01-28,6,1,-121.4676218,38.5376211,6746,30183,4.47420693744441
"6747",2006-01-28,1,3,-121.5120524,38.65599922,6747,30186,4.47398843930636
"6748",2006-01-28,1,5,-121.4879558,38.61308889,6748,30191,4.47406639004149
"6749",2006-01-28,1,3,-121.5149397,38.66706644,6749,30194,4.47384797747814
"6750",2006-01-28,5,5,-121.4383197,38.47377656,6750,30199,4.47392592592593
"6751",2006-01-28,2,7,-121.4418186,38.62503478,6751,30206,4.47430010368834
"6752",2006-01-28,6,7,-121.4692389,38.54913129,6752,30213,4.47467417061611
"6753",2006-01-28,1,5,-121.4755286,38.6296517,6753,30218,4.47475196209092
"6754",2006-01-28,4,7,-121.4778223,38.53874125,6754,30225,4.47512585134735
"6755",2006-01-28,4,5,-121.4814552,38.51848156,6755,30230,4.47520355292376
"6756",2006-01-28,6,2,-121.4425904,38.52497346,6756,30232,4.47483718176436
"6757",2006-01-28,3,8,-121.418725,38.57495865,6757,30240,4.47535888708007
"6758",2006-01-28,1,3,-121.4770508,38.60968463,6758,30243,4.47514057413436
"6759",2006-01-28,1,5,-121.4755625,38.61124309,6759,30248,4.47521822754845
"6760",2006-01-28,6,3,-121.4089209,38.54701012,6760,30251,4.475
"6761",2006-01-28,3,3,-121.474863,38.56270817,6761,30254,4.47478183700636
"6762",2006-01-28,4,4,-121.4972545,38.56201402,6762,30258,4.47471162377995
"6763",2006-01-28,6,6,-121.4181141,38.50576856,6763,30264,4.47493715806595
"6764",2006-01-28,2,1,-121.4258271,38.6017616,6764,30265,4.4744234180958
"6765",2006-01-28,2,4,-121.4370597,38.6323599,6765,30269,4.47435328898744
"6766",2006-01-28,2,1,-121.4670947,38.62320968,6766,30270,4.47383978717115
"6767",2006-01-28,5,5,-121.4568119,38.47375784,6767,30275,4.47391754100783
"6768",2006-01-28,2,7,-121.4487548,38.61844752,6768,30282,4.47429078014184
"6769",2006-01-28,5,4,-121.4358838,38.46465639,6769,30286,4.47422071206973
"6770",2006-01-28,6,7,-121.465047,38.53877351,6770,30293,4.47459379615953
"6771",2006-01-28,3,1,-121.4965346,38.5663989,6771,30294,4.47408063801506
"6772",2006-01-28,1,5,-121.5085026,38.65023973,6772,30299,4.47415829887773
"6773",2006-01-28,3,6,-121.4257169,38.55981942,6773,30305,4.47438358186919
"6774",2006-01-28,2,4,-121.456104,38.65069763,6774,30309,4.47431355181577
"6775",2006-01-28,2,1,-121.4252477,38.60027317,6775,30310,4.47380073800738
"6776",2006-01-28,2,1,-121.4305818,38.6364856,6776,30311,4.4732880755608
"6777",2006-01-28,2,3,-121.4215936,38.63921174,6777,30314,4.473070680242
"6778",2006-01-28,6,2,-121.4723187,38.55349495,6778,30316,4.47270581292417
"6779",2006-01-28,2,6,-121.4243039,38.61878441,6779,30322,4.4729311107833
"6780",2006-01-28,4,3,-121.4712477,38.52718667,6780,30325,4.47271386430678
"6781",2006-01-28,6,6,-121.4181141,38.50576856,6781,30331,4.47293909452883
"6782",2006-01-28,3,1,-121.4959147,38.57938174,6782,30332,4.47242701268063
"6783",2006-01-28,6,5,-121.4243203,38.54783739,6783,30337,4.47250479139024
"6784",2006-01-28,6,5,-121.4653678,38.55196925,6784,30342,4.47258254716981
"6785",2006-01-28,1,4,-121.4893334,38.62011633,6785,30346,4.47251289609433
"6786",2006-01-28,2,1,-121.4258271,38.6017616,6786,30347,4.47200117889773
"6787",2006-01-28,4,1,-121.5304705,38.48463859,6787,30348,4.47148961249447
"6788",2006-01-28,4,2,-121.4848506,38.50809786,6788,30350,4.47112551561579
"6789",2006-01-28,3,8,-121.4773354,38.5722972,6789,30358,4.47164530858742
"6790",2006-01-28,4,1,-121.4794301,38.511009,6790,30359,4.47113402061856
"6791",2006-01-28,5,1,-121.428371,38.45814178,6791,30360,4.4706228832278
"6792",2006-01-28,5,5,-121.42717,38.47421612,6792,30365,4.47070082449941
"6793",2006-01-28,4,4,-121.4964039,38.52941329,6793,30369,4.47063153245989
"6794",2006-01-28,2,8,-121.456171,38.60108154,6794,30377,4.471151015602
"6795",2006-01-28,2,2,-121.4227982,38.61584425,6795,30379,4.47078734363503
"6796",2006-01-28,1,3,-121.4901693,38.62510114,6796,30382,4.47057092407298
"6797",2006-01-28,3,2,-121.4952908,38.579563,6797,30384,4.47020744446079
"6798",2006-01-28,6,1,-121.4593645,38.54677899,6798,30385,4.46969696969697
"6799",2006-01-28,4,7,-121.54231,38.49063924,6799,30392,4.47006912781291
"6800",2006-01-28,4,7,-121.5389783,38.5077414,6800,30399,4.47044117647059
"6801",2006-01-28,3,7,-121.5091396,38.5755613,6801,30406,4.47081311571828
"6802",2006-01-28,5,7,-121.4816108,38.48839224,6802,30413,4.47118494560423
"6803",2006-01-28,2,7,-121.4297591,38.63647881,6803,30420,4.47155666617669
"6804",2006-01-28,5,1,-121.4271773,38.4706931,6804,30421,4.47104644326867
"6805",2006-01-28,4,7,-121.5426241,38.49832634,6805,30428,4.47141807494489
"6806",2006-01-28,2,5,-121.4350612,38.60888881,6806,30433,4.47149573905378
"6807",2006-01-28,1,1,-121.4769551,38.6308389,6807,30434,4.47098574996327
"6808",2006-01-28,6,6,-121.4383522,38.51585289,6808,30440,4.47121034077556
"6809",2006-01-28,2,3,-121.4306279,38.60134596,6809,30443,4.47099427228668
"6810",2006-01-28,5,4,-121.4312015,38.47591105,6810,30447,4.47092511013216
"6811",2006-01-28,2,1,-121.42747,38.60154457,6811,30448,4.47041550433123
"6812",2006-01-28,5,7,-121.4684313,38.48151147,6812,30455,4.47078684674105
"6813",2006-01-28,2,6,-121.3815598,38.63862878,6813,30461,4.4710113019228
"6814",2006-01-28,4,3,-121.4857747,38.49574798,6814,30464,4.47079542119166
"6815",2006-01-28,5,2,-121.441368,38.47392039,6815,30466,4.47043286867205
"6816",2006-01-28,3,7,-121.4069516,38.556361,6816,30473,4.47080399061033
"6817",2006-01-28,3,1,-121.4976906,38.57905171,6817,30474,4.47029485110752
"6818",2006-01-28,6,5,-121.4125586,38.53411717,6818,30479,4.47037254326782
"6819",2006-01-28,1,1,-121.4806029,38.62939722,6819,30480,4.46986361636604
"6820",2006-01-28,4,1,-121.4972545,38.56201402,6820,30481,4.46935483870968
"6821",2006-01-28,5,3,-121.4653782,38.49596852,6821,30484,4.46913942237209
"6822",2006-01-28,2,4,-121.4258271,38.6017616,6822,30488,4.46907065376722
"6823",2006-01-28,3,2,-121.4951045,38.58165459,6823,30490,4.46870877912942
"6824",2006-01-28,2,3,-121.4438516,38.61435185,6824,30493,4.46849355216882
"6825",2006-01-28,3,1,-121.4696858,38.57274295,6825,30494,4.46798534798535
"6826",2006-01-28,1,7,-121.5093115,38.67160923,6826,30501,4.46835628479344
"6827",2006-01-28,6,6,-121.4181141,38.50576856,6827,30507,4.46858063571115
"6828",2006-01-28,1,6,-121.5093439,38.66842409,6828,30513,4.46880492091388
"6829",2006-01-28,2,5,-121.4577335,38.64731678,6829,30518,4.46888270610631
"6830",2006-01-28,1,5,-121.5213017,38.60950253,6830,30523,4.46896046852123
"6831",2006-01-28,2,5,-121.4603623,38.64603297,6831,30528,4.46903820816864
"6832",2006-01-28,4,3,-121.4990149,38.52199137,6832,30531,4.46882318501171
"6833",2006-01-28,4,3,-121.5233627,38.49645546,6833,30534,4.46860822479145
"6834",2006-01-28,6,1,-121.4409716,38.52145084,6834,30535,4.46810067310506
"6835",2006-01-28,6,5,-121.4233804,38.51052896,6835,30540,4.46817849305048
"6836",2006-01-28,6,8,-121.4152234,38.51054018,6836,30548,4.46869514335869
"6837",2006-01-28,4,1,-121.4717471,38.52488785,6837,30549,4.4681878016674
"6838",2006-01-28,5,7,-121.4725547,38.49364271,6838,30556,4.46855805791167
"6839",2006-01-28,4,7,-121.4929888,38.53627695,6839,30563,4.46892820587805
"6840",2006-01-28,6,5,-121.4400119,38.52393677,6840,30568,4.46900584795322
"6841",2006-01-28,1,5,-121.4806029,38.62939722,6841,30573,4.46908346732934
"6842",2006-01-28,5,7,-121.505615,38.49156732,6842,30580,4.46945337620579
"6843",2006-01-28,1,4,-121.4978994,38.62741952,6843,30584,4.46938477276048
"6844",2006-01-28,4,1,-121.4717471,38.52488785,6844,30585,4.46887784921099
"6845",2006-01-28,3,2,-121.4984909,38.57966477,6845,30587,4.46851716581446
"6846",2006-01-28,2,6,-121.3815598,38.63862878,6846,30593,4.46874087058136
"6847",2006-01-28,5,1,-121.4803392,38.48452574,6847,30594,4.46823426318096
"6848",2006-01-28,5,3,-121.447555,38.46703034,6848,30597,4.46801985981308
"6849",2006-01-28,6,5,-121.4509002,38.53121355,6849,30602,4.46809753248649
"6850",2006-01-28,6,9,-121.4653678,38.55196925,6850,30611,4.46875912408759
"6851",2006-01-28,1,2,-121.4978994,38.62741952,6851,30613,4.46839877390162
"6852",2006-01-28,3,4,-121.4945262,38.57440554,6852,30617,4.46833041447753
"6853",2006-01-28,6,4,-121.4476033,38.5249316,6853,30621,4.46826207500365
"6854",2006-01-28,1,5,-121.4823352,38.63331793,6854,30626,4.46833965567552
"6855",2006-01-28,5,8,-121.4196758,38.4748515,6855,30634,4.46885485047411
"6856",2006-01-28,2,4,-121.4308978,38.63592424,6856,30638,4.46878646441074
"6857",2006-01-28,3,4,-121.4910186,38.56987859,6857,30642,4.46871809829371
"6858",2006-01-28,5,1,-121.4518481,38.47833936,6858,30643,4.46821230679498
"6859",2006-01-28,4,3,-121.497206,38.52472122,6859,30646,4.46799825047383
"6860",2006-01-28,4,7,-121.4919771,38.55905282,6860,30653,4.46836734693878
"6861",2006-01-28,1,3,-121.5321299,38.64304161,6861,30656,4.46815333041831
"6862",2006-01-28,2,3,-121.4258885,38.59891162,6862,30659,4.46793937627514
"6863",2006-01-28,6,3,-121.4666875,38.54802942,6863,30662,4.46772548448201
"6864",2006-01-28,3,5,-121.4192296,38.57227839,6864,30667,4.46780303030303
"6865",2006-01-28,3,7,-121.4834127,38.57884334,6865,30674,4.46817188638019
"6866",2006-01-28,6,5,-121.4688287,38.54176204,6866,30679,4.46824934459656
"6867",2006-01-28,5,1,-121.4227089,38.47428454,6867,30680,4.46774428425805
"6868",2006-01-28,5,2,-121.4289328,38.46475681,6868,30682,4.4673849737915
"6869",2006-01-28,2,1,-121.4618676,38.64330227,6869,30683,4.46688018634445
"6870",2006-01-28,2,6,-121.435967,38.63993888,6870,30689,4.46710334788937
"6871",2006-01-28,5,5,-121.4271773,38.4706931,6871,30694,4.46718090525397
"6872",2006-01-28,2,6,-121.3815598,38.63862878,6872,30700,4.4674039580908
"6873",2006-01-28,2,6,-121.3815598,38.63862878,6873,30706,4.46762694602066
"6874",2006-01-28,6,7,-121.4724356,38.55612335,6874,30713,4.46799534477742
"6875",2006-01-28,5,3,-121.475345,38.48146892,6875,30716,4.46778181818182
"6876",2006-01-28,3,5,-121.4670118,38.57203045,6876,30721,4.46785922047702
"6877",2006-01-28,6,4,-121.419844,38.52597099,6877,30725,4.46779118801803
"6878",2006-01-28,1,2,-121.4978994,38.62741952,6878,30727,4.46743239313754
"6879",2006-01-28,3,7,-121.4705946,38.57943348,6879,30734,4.46780055240587
"6880",2006-01-28,2,5,-121.4368602,38.63678539,6880,30739,4.46787790697674
"6881",2006-01-28,2,7,-121.4275537,38.59808509,6881,30746,4.46824589449208
"6882",2006-01-28,3,7,-121.4357584,38.56722246,6882,30753,4.46861377506539
"6883",2006-01-28,5,1,-121.42717,38.47421612,6883,30754,4.4681098358274
"6884",2006-01-28,5,5,-121.4856682,38.48045537,6884,30759,4.46818710052295
"6885",2006-01-28,2,4,-121.3815598,38.63862878,6885,30763,4.46811909949165
"6886",2006-01-28,5,5,-121.4196575,38.47581524,6886,30768,4.46819634040081
"6887",2006-01-28,6,3,-121.4401734,38.52875394,6887,30771,4.46798315667199
"6888",2006-01-28,3,7,-121.4907988,38.57960099,6888,30778,4.46835075493612
"6889",2006-01-28,1,5,-121.4840542,38.60911743,6889,30783,4.4684279285818
"6890",2006-01-28,1,2,-121.4768376,38.61489271,6890,30785,4.46806966618287
"6891",2006-01-28,6,5,-121.4607739,38.54118933,6891,30790,4.46814685822087
"6892",2006-01-29,5,5,-121.4284227,38.4643369,6892,30795,4.46822402785839
"6893",2006-01-29,5,5,-121.4355908,38.47345298,6893,30800,4.46830117510518
"6894",2006-01-29,6,3,-121.4731883,38.54464324,6894,30803,4.46808819263127
"6895",2006-01-29,1,7,-121.5026094,38.63167132,6895,30810,4.46845540246555
"6896",2006-01-29,5,4,-121.4110382,38.4467991,6896,30814,4.46838747099768
"6897",2006-01-29,1,4,-121.4990726,38.68164024,6897,30818,4.46831955922865
"6898",2006-01-29,1,7,-121.50537,38.66670198,6898,30825,4.46868657581908
"6899",2006-01-29,1,4,-121.4801,38.60907503,6899,30829,4.46861864038266
"6900",2006-01-29,3,4,-121.4903803,38.56963689,6900,30833,4.46855072463768
"6901",2006-01-29,5,7,-121.4357342,38.47696574,6901,30840,4.46891754818142
"6902",2006-01-29,1,8,-121.4901695,38.62262156,6902,30848,4.46942915097073
"6903",2006-01-29,3,2,-121.4868264,38.57696108,6903,30850,4.46907141822396
"6904",2006-01-29,3,7,-121.4662897,38.57271087,6904,30857,4.46943800695249
"6905",2006-01-29,3,3,-121.4855965,38.58064891,6905,30860,4.46922519913106
"6906",2006-01-29,3,5,-121.4427516,38.55941392,6906,30865,4.46930205618303
"6907",2006-01-29,5,1,-121.4614649,38.47324689,6907,30866,4.46879976835095
"6908",2006-01-29,1,7,-121.5232247,38.60872513,6908,30873,4.46916618413434
"6909",2006-01-29,3,7,-121.4861055,38.56631737,6909,30880,4.4695324938486
"6910",2006-01-29,2,3,-121.4622984,38.64605845,6910,30883,4.46931982633864
"6911",2006-01-29,2,6,-121.4568936,38.64404243,6911,30889,4.46954131095355
"6912",2006-01-29,3,4,-121.4692575,38.57201606,6912,30893,4.46947337962963
"6913",2006-01-29,3,8,-121.4699112,38.57395494,6913,30901,4.46998408795024
"6914",2006-01-29,4,7,-121.5056977,38.54979527,6914,30908,4.47035001446341
"6915",2006-01-29,6,5,-121.467861,38.55008879,6915,30913,4.4704266088214
"6916",2006-01-29,2,8,-121.4615545,38.60456659,6916,30921,4.47093695777906
"6917",2006-01-29,4,3,-121.4816091,38.53435928,6917,30924,4.47072430244326
"6918",2006-01-29,6,9,-121.3967577,38.52491379,6918,30933,4.47137901127493
"6919",2006-01-29,6,2,-121.4469248,38.53445955,6919,30935,4.471021823963
"6920",2006-01-29,3,8,-121.4878161,38.5857662,6920,30943,4.47153179190751
"6921",2006-01-29,3,5,-121.4617826,38.57433757,6921,30948,4.4716081491114
"6922",2006-01-29,5,7,-121.4941668,38.47857071,6922,30955,4.47197341808726
"6923",2006-01-29,3,7,-121.5046674,38.57833762,6923,30962,4.47233858153979
"6924",2006-01-29,4,4,-121.5349291,38.48718561,6924,30966,4.47227036395147
"6925",2006-01-29,3,3,-121.4818932,38.5857673,6925,30969,4.47205776173285
"6926",2006-01-29,6,1,-121.4243203,38.54783739,6926,30970,4.47155645394167
"6927",2006-01-29,3,9,-121.4878161,38.5857662,6927,30979,4.47221019200231
"6928",2006-01-29,4,5,-121.4811949,38.53554642,6928,30984,4.47228637413395
"6929",2006-01-29,6,1,-121.4674364,38.55451604,6929,30985,4.47178525039688
"6930",2006-01-29,5,7,-121.4635225,38.47925635,6930,30992,4.47215007215007
"6931",2006-01-29,2,5,-121.4315485,38.62852162,6931,30997,4.47222622998124
"6932",2006-01-29,4,4,-121.5537592,38.50798335,6932,31001,4.47215810732833
"6933",2006-01-29,3,6,-121.3917421,38.55809165,6933,31007,4.4723784797346
"6934",2006-01-29,1,5,-121.4828059,38.63020065,6934,31012,4.4724545716758
"6935",2006-01-29,6,9,-121.4438874,38.52496323,6935,31021,4.47310742609949
"6936",2006-01-29,3,7,-121.5046674,38.57833762,6936,31028,4.47347174163783
"6937",2006-01-29,4,5,-121.5333381,38.47670073,6937,31033,4.47354764307337
"6938",2006-01-29,4,3,-121.5072531,38.56559378,6938,31036,4.47333525511675
"6939",2006-01-29,3,2,-121.4911942,38.58057479,6939,31038,4.47297881539127
"6940",2006-01-29,1,3,-121.5098944,38.66833855,6940,31041,4.47276657060519
"6941",2006-01-29,6,3,-121.4612421,38.55003619,6941,31044,4.47255438697594
"6942",2006-01-29,3,5,-121.4911942,38.58057479,6942,31049,4.47263036588879
"6943",2006-01-29,2,8,-121.4652701,38.60046764,6943,31057,4.47313841278986
"6944",2006-01-29,4,6,-121.479014,38.53881527,6944,31063,4.47335829493088
"6945",2006-01-29,1,3,-121.4768064,38.62296014,6945,31066,4.47314614830814
"6946",2006-01-29,6,2,-121.4734141,38.54484473,6946,31068,4.47279009501872
"6947",2006-01-29,5,7,-121.422795,38.47529548,6947,31075,4.47315387937239
"6948",2006-01-29,1,1,-121.5050821,38.61284481,6948,31076,4.47265400115141
"6949",2006-01-29,1,5,-121.5061726,38.63276571,6949,31081,4.47272988919269
"6950",2006-01-29,6,7,-121.449896,38.52951178,6950,31088,4.47309352517986
"6951",2006-01-29,5,6,-121.5019436,38.48998089,6951,31094,4.47331319234643
"6952",2006-01-29,6,4,-121.4552803,38.54726509,6952,31098,4.47324510932106
"6953",2006-01-29,5,1,-121.4133413,38.45718227,6953,31099,4.47274557744858
"6954",2006-01-29,6,7,-121.4689006,38.55699686,6954,31106,4.47310900201323
"6955",2006-01-29,3,6,-121.4744796,38.57820727,6955,31112,4.47332854061826
"6956",2006-01-29,6,2,-121.4701898,38.55292779,6956,31114,4.47297297297297
"6957",2006-01-29,3,5,-121.5021287,38.59674646,6957,31119,4.47304872789996
"6958",2006-01-29,5,7,-121.4256977,38.44792733,6958,31126,4.47341189997126
"6959",2006-01-29,6,5,-121.4328808,38.52881453,6959,31131,4.47348757005317
"6960",2006-01-29,6,4,-121.4568045,38.55374444,6960,31135,4.47341954022988
"6961",2006-01-29,2,8,-121.4468944,38.63537838,6961,31143,4.47392616003448
"6962",2006-01-29,2,7,-121.4306279,38.60134596,6962,31150,4.47428899741454
"6963",2006-01-29,2,4,-121.4585395,38.62741249,6963,31154,4.47422088180382
"6964",2006-01-29,3,6,-121.4726456,38.57881951,6964,31160,4.4744399770247
"6965",2006-01-29,3,5,-121.4983269,38.56567077,6965,31165,4.47451543431443
"6966",2006-01-29,5,7,-121.4189709,38.47433721,6966,31172,4.47487797875395
"6967",2006-01-29,6,6,-121.4181141,38.50576856,6967,31178,4.47509688531649
"6968",2006-01-29,4,3,-121.4857011,38.55982692,6968,31181,4.47488518943743
"6969",2006-01-29,2,7,-121.4249294,38.59851693,6969,31188,4.47524752475248
"6970",2006-01-29,5,5,-121.4210137,38.46148268,6970,31193,4.47532281205165
"6971",2006-01-29,6,6,-121.4115515,38.52524262,6971,31199,4.47554152919237
"6972",2006-01-29,5,7,-121.4525422,38.48211558,6972,31206,4.47590361445783
"6973",2006-01-29,1,2,-121.5264198,38.62453557,6973,31208,4.47554854438549
"6974",2006-01-29,5,7,-121.4404459,38.4725814,6974,31215,4.47591052480642
"6975",2006-01-29,1,7,-121.491566,38.6250908,6975,31222,4.47627240143369
"6976",2006-01-29,6,7,-121.4367764,38.51447225,6976,31229,4.47663417431193
"6977",2006-01-29,6,3,-121.3897055,38.53125566,6977,31232,4.47642253117386
"6978",2006-01-29,4,3,-121.4984736,38.56321928,6978,31235,4.4762109486959
"6979",2006-01-29,5,7,-121.4529099,38.47333853,6979,31242,4.47657257486746
"6980",2006-01-29,2,5,-121.4587507,38.64016562,6980,31247,4.47664756446991
"6981",2006-01-29,2,5,-121.4587507,38.64016562,6981,31252,4.47672253258845
"6982",2006-01-29,1,3,-121.504924,38.62149931,6982,31255,4.47651102835864
"6983",2006-01-29,2,1,-121.426719,38.62009248,6983,31256,4.47601317485321
"6984",2006-01-29,4,8,-121.4803911,38.51197714,6984,31264,4.47651775486827
"6985",2006-01-29,5,5,-121.4597711,38.46304879,6985,31269,4.47659269863994
"6986",2006-01-29,3,5,-121.489627,38.57275295,6986,31274,4.4766676209562
"6987",2006-01-29,6,8,-121.4599213,38.54852526,6987,31282,4.47717189065407
"6988",2006-01-29,5,7,-121.4988814,38.48920978,6988,31289,4.47753291356611
"6989",2006-01-29,3,4,-121.4714677,38.56452151,6989,31293,4.47746458720847
"6990",2006-01-29,1,4,-121.5055312,38.63589608,6990,31297,4.47739628040057
"6991",2006-01-29,2,7,-121.451402,38.65788081,6991,31304,4.47775711629238
"6992",2006-01-29,4,7,-121.4908684,38.54338237,6992,31311,4.47811784897025
"6993",2006-01-29,6,2,-121.4438874,38.52496323,6993,31313,4.47776347776348
"6994",2006-01-29,5,2,-121.4882958,38.47695497,6994,31315,4.47740920789248
"6995",2006-01-29,2,5,-121.4308265,38.60058081,6995,31320,4.47748391708363
"6996",2006-01-29,4,4,-121.5147548,38.52347262,6996,31324,4.47741566609491
"6997",2006-01-29,2,7,-121.4018388,38.63438017,6997,31331,4.47777618979563
"6998",2006-01-29,2,4,-121.4237298,38.59800846,6998,31335,4.47770791654759
"6999",2006-01-29,3,7,-121.4846466,38.58283595,6999,31342,4.47806829547078
"7000",2006-01-29,5,4,-121.4176675,38.45768744,7000,31346,4.478
"7001",2006-01-29,2,7,-121.4372414,38.60534892,7001,31353,4.47836023425225
"7002",2006-01-29,4,1,-121.5076289,38.48123472,7002,31354,4.47786346758069
"7003",2006-01-29,5,3,-121.4867615,38.47706899,7003,31357,4.47765243467086
"7004",2006-01-29,3,5,-121.4852125,38.57810996,7004,31362,4.47772701313535
"7005",2006-01-29,5,2,-121.4652727,38.48999286,7005,31364,4.4773733047823
"7006",2006-01-29,6,7,-121.4141329,38.52291342,7006,31371,4.47773337139595
"7007",2006-01-29,6,7,-121.4600028,38.54236923,7007,31378,4.47809333523619
"7008",2006-01-29,2,5,-121.4528714,38.63298758,7008,31383,4.47816780821918
"7009",2006-01-29,2,2,-121.4652496,38.64799426,7009,31385,4.47781423883578
"7010",2006-01-29,5,1,-121.438791,38.46046924,7010,31386,4.47731811697575
"7011",2006-01-29,2,7,-121.4430659,38.63429736,7011,31393,4.47767793467408
"7012",2006-01-29,1,7,-121.5160014,38.60770663,7012,31400,4.4780376497433
"7013",2006-01-29,1,4,-121.5381824,38.62757337,7013,31404,4.47796948524169
"7014",2006-01-29,6,4,-121.4679114,38.53207838,7014,31408,4.47790134017679
"7015",2006-01-29,4,4,-121.4854383,38.5594166,7015,31412,4.47783321454027
"7016",2006-01-29,3,5,-121.4659345,38.57109736,7016,31417,4.47790763968073
"7017",2006-01-29,6,4,-121.4334782,38.52005788,7017,31421,4.47783953256377
"7018",2006-01-29,1,7,-121.4992718,38.68221226,7018,31428,4.47819891707039
"7019",2006-01-29,3,3,-121.4820477,38.58423851,7019,31431,4.47798831742413
"7020",2006-01-29,4,8,-121.535854,38.47979453,7020,31439,4.47849002849003
"7021",2006-01-29,4,4,-121.4881604,38.56020578,7021,31443,4.47842187722547
"7022",2006-01-29,5,6,-121.4630104,38.48093723,7022,31449,4.47863856451154
"7023",2006-01-29,5,5,-121.4198197,38.47305088,7023,31454,4.47871280079738
"7024",2006-01-29,3,7,-121.504449,38.57804836,7024,31461,4.47907175398633
"7025",2006-01-29,5,6,-121.4538072,38.48435676,7025,31467,4.47928825622776
"7026",2006-01-29,3,7,-121.4974538,38.58137649,7026,31474,4.47964702533447
"7027",2006-01-29,1,6,-121.4789238,38.62109421,7027,31480,4.47986338408994
"7028",2006-01-29,2,8,-121.4509888,38.64196888,7028,31488,4.48036425725669
"7029",2006-01-29,3,2,-121.4911988,38.58385621,7029,31490,4.48001138141983
"7030",2006-01-29,1,5,-121.4978994,38.62741952,7030,31495,4.4800853485064
"7031",2006-01-29,5,4,-121.4704919,38.49382275,7031,31499,4.4800170672735
"7032",2006-01-29,5,3,-121.4374694,38.46111086,7032,31502,4.47980659840728
"7033",2006-01-29,5,5,-121.488184,38.47647394,7033,31507,4.47988056305986
"7034",2006-01-29,5,6,-121.4534037,38.47682822,7034,31513,4.48009667330111
"7035",2006-01-29,2,4,-121.4432065,38.61495011,7035,31517,4.48002842928216
"7036",2006-01-29,4,5,-121.497206,38.52472122,7036,31522,4.48010233086981
"7037",2006-01-29,6,7,-121.4259126,38.50941846,7037,31529,4.48046042347591
"7038",2006-01-29,2,5,-121.4613745,38.62422669,7038,31534,4.48053424268258
"7039",2006-01-29,5,5,-121.4553915,38.46946748,7039,31539,4.4806080409149
"7040",2006-01-29,3,5,-121.4868685,38.5856961,7040,31544,4.48068181818182
"7041",2006-01-29,1,5,-121.4828059,38.63020065,7041,31549,4.48075557449226
"7042",2006-01-29,2,5,-121.4421371,38.61475001,7042,31554,4.48082930985515
"7043",2006-01-29,6,5,-121.4243203,38.54783739,7043,31559,4.48090302427943
"7044",2006-01-29,5,2,-121.4298714,38.46354773,7044,31561,4.4805508233958
"7045",2006-01-29,1,6,-121.5097637,38.67460145,7045,31567,4.48076650106458
"7046",2006-01-29,2,6,-121.4443044,38.62721053,7046,31573,4.48098211751348
"7047",2006-01-29,5,5,-121.4662216,38.47334584,7047,31578,4.48105576841209
"7048",2006-01-29,1,8,-121.4808309,38.6226048,7048,31586,4.48155505107832
"7049",2006-01-29,5,5,-121.4271773,38.4706931,7049,31591,4.48162859980139
"7050",2006-01-29,5,7,-121.4196575,38.47581524,7050,31598,4.48198581560284
"7051",2006-01-29,5,5,-121.4198197,38.47305088,7051,31603,4.48205928237129
"7052",2006-01-29,5,4,-121.4220431,38.45899451,7052,31607,4.48199092456041
"7053",2006-01-29,4,4,-121.4752908,38.49930905,7053,31611,4.48192258613356
"7054",2006-01-29,5,5,-121.4809938,38.48242529,7054,31616,4.48199603062092
"7055",2006-01-29,4,4,-121.4828012,38.5478719,7055,31620,4.48192771084337
"7056",2006-01-29,2,1,-121.4313085,38.63008563,7056,31621,4.48143424036281
"7057",2006-01-29,1,7,-121.4929801,38.61526655,7057,31628,4.48179112937509
"7058",2006-01-29,2,5,-121.4619611,38.59937865,7058,31633,4.48186455086427
"7059",2006-01-29,6,5,-121.4484308,38.53048786,7059,31638,4.48193795155121
"7060",2006-01-29,5,5,-121.4297516,38.47199917,7060,31643,4.48201133144476
"7061",2006-01-29,2,8,-121.4642334,38.62621427,7061,31651,4.48250955955247
"7062",2006-01-29,2,1,-121.4536771,38.63794231,7062,31652,4.48201642594166
"7063",2006-01-29,6,1,-121.4425904,38.52497346,7063,31653,4.48152343196942
"7064",2006-01-29,6,3,-121.4704184,38.55416451,7064,31656,4.48131370328426
"7065",2006-01-29,3,1,-121.4093507,38.55380855,7065,31657,4.48082094833687
"7066",2006-01-29,1,1,-121.4755308,38.62697168,7066,31658,4.48032833286159
"7067",2006-01-29,6,1,-121.4111198,38.51613758,7067,31659,4.47983585679921
"7068",2006-01-29,5,1,-121.4354311,38.47155475,7068,31660,4.47934352009055
"7069",2006-01-29,1,8,-121.4911606,38.61569243,7069,31668,4.47984156174848
"7070",2006-01-29,1,8,-121.4782039,38.61471215,7070,31676,4.48033946251768
"7071",2006-01-29,3,2,-121.4642474,38.57498057,7071,31678,4.479988686183
"7072",2006-01-29,3,7,-121.4149612,38.55576196,7072,31685,4.48034502262443
"7073",2006-01-29,4,3,-121.4918953,38.56268259,7073,31688,4.48013572741411
"7074",2006-01-30,4,7,-121.482806,38.51391562,7074,31695,4.480491942324
"7075",2006-01-30,2,3,-121.4508063,38.60931053,7075,31698,4.48028268551237
"7076",2006-01-30,5,7,-121.4631785,38.49017812,7076,31705,4.48063877897117
"7077",2006-01-30,5,7,-121.466764,38.49754834,7077,31712,4.48099477179596
"7078",2006-01-30,3,4,-121.4836065,38.56318411,7078,31716,4.4809268154846
"7079",2006-01-30,1,3,-121.5119979,38.65731154,7079,31719,4.48071761548241
"7080",2006-01-30,5,7,-121.4331228,38.44595945,7080,31726,4.48107344632768
"7081",2006-01-30,3,6,-121.5005845,38.57243004,7081,31732,4.48128795367886
"7082",2006-01-30,3,4,-121.5023734,38.57170184,7082,31736,4.48121999435188
"7083",2006-01-30,3,7,-121.4385767,38.56775515,7083,31743,4.48157560355781
"7084",2006-01-30,6,4,-121.4038889,38.53073649,7084,31747,4.48150762281197
"7085",2006-01-30,4,6,-121.5196388,38.53269738,7085,31753,4.48172194777699
"7086",2006-01-30,3,3,-121.4832083,38.5717991,7086,31756,4.4815128422241
"7087",2006-01-30,6,6,-121.3993829,38.54609328,7087,31762,4.48172710596867
"7088",2006-01-30,3,7,-121.4055845,38.55213345,7088,31769,4.48208239277652
"7089",2006-01-30,4,3,-121.5136342,38.48889933,7089,31772,4.48187332486952
"7090",2006-01-30,5,4,-121.475678,38.48606988,7090,31776,4.48180535966149
"7091",2006-01-30,6,5,-121.4526189,38.53182855,7091,31781,4.48187843745593
"7092",2006-01-30,5,7,-121.461782,38.47938006,7092,31788,4.48223350253807
"7093",2006-01-30,5,2,-121.4161718,38.46337225,7093,31790,4.48188354715917
"7094",2006-01-30,4,3,-121.5048587,38.5225465,7094,31793,4.48167465463772
"7095",2006-01-30,4,2,-121.5241571,38.51724271,7095,31795,4.48132487667371
"7096",2006-01-30,3,3,-121.4828749,38.59367176,7096,31798,4.48111612175874
"7097",2006-01-30,2,1,-121.4700151,38.64235952,7097,31799,4.48062561645766
"7098",2006-01-30,5,2,-121.4312631,38.46377975,7098,31801,4.48027613412229
"7099",2006-01-30,6,5,-121.4511462,38.54195686,7099,31806,4.48034934497817
"7100",2006-01-30,6,1,-121.4211484,38.53236461,7100,31807,4.47985915492958
"7101",2006-01-30,2,7,-121.4168744,38.64645661,7101,31814,4.48021405435854
"7102",2006-01-30,6,2,-121.4678656,38.55181875,7102,31816,4.47986482680935
"7103",2006-01-30,6,2,-121.4461521,38.53266824,7103,31818,4.47951569759257
"7104",2006-01-30,5,3,-121.4514452,38.46985247,7104,31821,4.47930743243243
"7105",2006-01-30,2,1,-121.4349571,38.6237933,7105,31822,4.47881773399015
"7106",2006-01-30,4,5,-121.4925018,38.49707928,7106,31827,4.47889107796229
"7107",2006-01-30,5,5,-121.4369976,38.47799614,7107,31832,4.4789644012945
"7108",2006-01-30,2,4,-121.4205903,38.60845211,7108,31836,4.47889701744513
"7109",2006-01-30,5,4,-121.4654193,38.48160193,7109,31840,4.4788296525531
"7110",2006-01-30,6,9,-121.4069526,38.51541882,7110,31849,4.47946554149086
"7111",2006-01-30,3,7,-121.4520801,38.57333372,7111,31856,4.47981999718746
"7112",2006-01-30,6,1,-121.4497148,38.53941555,7112,31857,4.47933070866142
"7113",2006-01-30,3,5,-121.4928671,38.5780037,7113,31862,4.47940390833685
"7114",2006-01-30,2,5,-121.4673258,38.6255448,7114,31867,4.47947708743323
"7115",2006-01-30,2,5,-121.4637581,38.61214737,7115,31872,4.47955024595924
"7116",2006-01-30,4,2,-121.4831332,38.51603145,7116,31874,4.47920179876335
"7117",2006-01-30,4,3,-121.4712477,38.52718667,7117,31877,4.47899395812842
"7118",2006-01-30,5,5,-121.4627597,38.49940254,7118,31882,4.47906715369486
"7119",2006-01-30,1,7,-121.4816532,38.62937447,7119,31889,4.47942126703189
"7120",2006-01-30,6,5,-121.4199397,38.51290623,7120,31894,4.47949438202247
"7121",2006-01-30,1,5,-121.4800628,38.61081853,7121,31899,4.47956747647802
"7122",2006-01-30,5,7,-121.4438063,38.4716585,7122,31906,4.47992137040157
"7123",2006-01-30,2,5,-121.4550081,38.62229397,7123,31911,4.4799943843886
"7124",2006-01-30,4,4,-121.4944073,38.56207026,7124,31915,4.47992700729927
"7125",2006-01-30,3,1,-121.4844897,38.59390962,7125,31916,4.47943859649123
"7126",2006-01-30,3,7,-121.4063772,38.55352423,7126,31923,4.47979230985125
"7127",2006-01-30,4,1,-121.4741684,38.53452891,7127,31924,4.47930405500211
"7128",2006-01-30,3,5,-121.3751255,38.5530906,7128,31929,4.4793771043771
"7129",2006-01-30,2,1,-121.4297591,38.63647881,7129,31930,4.47888904474681
"7130",2006-01-30,3,4,-121.4665491,38.5684229,7130,31934,4.47882187938289
"7131",2006-01-30,2,3,-121.4586425,38.6341268,7131,31937,4.47861450007012
"7132",2006-01-30,2,8,-121.4211269,38.62080882,7132,31945,4.47910824453169
"7133",2006-01-30,2,5,-121.4530304,38.61043866,7133,31950,4.47918127015281
"7134",2006-01-30,2,1,-121.4317129,38.63293516,7134,31951,4.47869358003925
"7135",2006-01-30,4,5,-121.5092931,38.5323931,7135,31956,4.47876664330764
"7136",2006-01-30,3,5,-121.3936338,38.55565493,7136,31961,4.47883968609866
"7137",2006-01-30,2,1,-121.4313085,38.63008563,7137,31962,4.47835224884405
"7138",2006-01-30,6,4,-121.4091236,38.52506274,7138,31966,4.47828523395909
"7139",2006-01-30,4,5,-121.4930327,38.53748261,7139,31971,4.47835831348928
"7140",2006-01-30,1,7,-121.4735004,38.60803197,7140,31978,4.47871148459384
"7141",2006-01-30,6,5,-121.4142712,38.51755951,7141,31983,4.47878448396583
"7142",2006-01-30,6,4,-121.4688287,38.54176204,7142,31987,4.47871744609353
"7143",2006-01-30,4,7,-121.4931002,38.52354452,7143,31994,4.47907041859163
"7144",2006-01-30,3,4,-121.4785526,38.56750828,7144,31998,4.47900335946249
"7145",2006-01-30,6,3,-121.4257827,38.5160081,7145,32001,4.47879636109167
"7146",2006-01-30,2,1,-121.4305962,38.63292418,7146,32002,4.47830954380073
"7147",2006-01-30,4,7,-121.5292089,38.51385568,7147,32009,4.47866237582202
"7148",2006-01-30,6,2,-121.4127677,38.5392971,7148,32011,4.47831561275881
"7149",2006-01-30,5,5,-121.4240366,38.44520881,7149,32016,4.4783885858162
"7150",2006-01-30,1,4,-121.4874303,38.63409297,7150,32020,4.47832167832168
"7151",2006-01-30,2,5,-121.4536911,38.60231104,7151,32025,4.47839463012166
"7152",2006-01-30,3,4,-121.4149596,38.55553953,7152,32029,4.47832774049217
"7153",2006-01-30,2,1,-121.4305818,38.6364856,7153,32030,4.47784146511953
"7154",2006-01-30,4,3,-121.4712477,38.52718667,7154,32033,4.47763488957227
"7155",2006-01-30,2,1,-121.429189,38.63290902,7155,32034,4.47714884696017
"7156",2006-01-30,2,1,-121.433145,38.62541828,7156,32035,4.47666294019005
"7157",2006-01-30,5,3,-121.475345,38.48146892,7157,32038,4.47645661590052
"7158",2006-01-30,2,1,-121.4464647,38.61633596,7158,32039,4.4759709416038
"7159",2006-01-30,3,3,-121.4994837,38.57327928,7159,32042,4.47576477161615
"7160",2006-01-30,2,1,-121.4487064,38.61112661,7160,32043,4.47527932960894
"7161",2006-01-30,2,1,-121.4307192,38.62585123,7161,32044,4.47479402318112
"7162",2006-01-30,6,5,-121.4709517,38.54165918,7162,32049,4.47486735548729
"7163",2006-01-30,2,5,-121.4569864,38.60842802,7163,32054,4.47494066731816
"7164",2006-01-30,2,1,-121.4307192,38.62585123,7164,32055,4.47445561139028
"7165",2006-01-30,2,6,-121.4527959,38.61317525,7165,32061,4.47466852756455
"7166",2006-01-30,6,5,-121.4053768,38.54264786,7166,32066,4.4747418364499
"7167",2006-01-30,4,5,-121.4794981,38.51558404,7167,32071,4.47481512487791
"7168",2006-01-30,6,1,-121.439786,38.54648541,7168,32072,4.47433035714286
"7169",2006-01-30,6,3,-121.4254625,38.54146972,7169,32075,4.47412470358488
"7170",2006-01-30,6,5,-121.4542609,38.55620383,7170,32080,4.4741980474198
"7171",2006-01-30,2,1,-121.433145,38.62541828,7171,32081,4.47371356853995
"7172",2006-01-30,6,1,-121.409069,38.51181048,7172,32082,4.47322922476297
"7173",2006-01-30,2,1,-121.433145,38.62541828,7173,32083,4.47274501603234
"7174",2006-01-30,6,1,-121.4274484,38.51052171,7174,32084,4.47226094229161
"7175",2006-01-30,2,5,-121.4220925,38.62691239,7175,32089,4.47233449477352
"7176",2006-01-30,2,1,-121.4605521,38.60939478,7176,32090,4.47185061315496
"7177",2006-01-30,6,2,-121.4723103,38.53949609,7177,32092,4.47150620036227
"7178",2006-01-30,5,6,-121.4673944,38.49407763,7178,32098,4.47171914182223
"7179",2006-01-30,4,4,-121.511165,38.56124982,7179,32102,4.47165343362585
"7180",2006-01-30,4,4,-121.4880268,38.52862139,7180,32106,4.47158774373259
"7181",2006-01-30,6,3,-121.4254625,38.54146972,7181,32109,4.47138281576382
"7182",2006-01-30,3,3,-121.5013162,38.56732576,7182,32112,4.47117794486216
"7183",2006-01-30,3,1,-121.4966071,38.57991197,7183,32113,4.47069469580955
"7184",2006-01-30,6,2,-121.4120175,38.54505704,7184,32115,4.47035077951002
"7185",2006-01-30,4,7,-121.4774388,38.55770025,7185,32122,4.47070285316632
"7186",2006-01-30,4,9,-121.4990149,38.52199137,7186,32131,4.47133314778736
"7187",2006-01-30,1,5,-121.471972,38.63200804,7187,32136,4.4714067065535
"7188",2006-01-30,1,5,-121.4806029,38.62939722,7188,32141,4.47148024485253
"7189",2006-01-30,2,4,-121.4499687,38.60673086,7189,32145,4.47141466128808
"7190",2006-01-30,6,4,-121.4655517,38.54142018,7190,32149,4.47134909596662
"7191",2006-01-30,2,7,-121.4660389,38.62444324,7191,32156,4.4717007370324
"7192",2006-01-30,3,2,-121.4120889,38.56864789,7192,32158,4.47135706340378
"7193",2006-01-30,2,5,-121.4415705,38.61111988,7193,32163,4.47143055748645
"7194",2006-01-30,6,5,-121.4546045,38.55426406,7194,32168,4.47150403113706
"7195",2006-01-30,6,5,-121.4109169,38.50048461,7195,32173,4.47157748436414
"7196",2006-01-30,4,7,-121.4740915,38.49609085,7196,32180,4.47192884936076
"7197",2006-01-30,2,3,-121.4303283,38.63228581,7197,32183,4.47172432958177
"7198",2006-01-30,6,1,-121.4425904,38.52497346,7198,32184,4.47124201166991
"7199",2006-01-30,3,1,-121.4070072,38.55050416,7199,32185,4.47075982775385
"7200",2006-01-30,4,7,-121.4908853,38.5488551,7200,32192,4.47111111111111
"7201",2006-01-30,3,5,-121.4976906,38.57905171,7201,32197,4.47118455770032
"7202",2006-01-30,2,3,-121.4549497,38.62260674,7202,32200,4.47098028325465
"7203",2006-01-30,3,4,-121.479575,38.56832842,7203,32204,4.47091489657087
"7204",2006-01-30,6,4,-121.402723,38.5363789,7204,32208,4.47084952803998
"7205",2006-01-30,4,1,-121.4959901,38.52663259,7205,32209,4.47036780013879
"7206",2006-01-30,6,5,-121.409083,38.51055016,7206,32214,4.47044129891757
"7207",2006-01-30,5,6,-121.437912,38.47188262,7207,32220,4.47065353128902
"7208",2006-01-30,5,3,-121.4465943,38.47427504,7208,32223,4.47044950055494
"7209",2006-01-30,6,5,-121.4462065,38.53106486,7209,32228,4.47052295741434
"7210",2006-01-30,6,8,-121.4443436,38.52652786,7210,32236,4.47101248266297
"7211",2006-01-30,6,1,-121.4497148,38.53941555,7211,32237,4.47053113299126
"7212",2006-01-30,1,6,-121.5059115,38.63709493,7212,32243,4.47074320576816
"7213",2006-01-30,5,3,-121.4859396,38.48934244,7213,32246,4.47053930403438
"7214",2006-01-30,5,6,-121.4859396,38.48934244,7214,32252,4.47075131688384
"7215",2006-01-30,1,2,-121.4978994,38.62741952,7215,32254,4.47040887040887
"7216",2006-01-30,3,1,-121.4841699,38.5839322,7216,32255,4.46992793791574
"7217",2006-01-30,2,1,-121.4392211,38.6183743,7217,32256,4.46944713870029
"7218",2006-01-30,5,5,-121.4176962,38.46573597,7218,32261,4.46952064283735
"7219",2006-01-30,2,1,-121.433145,38.62541828,7219,32262,4.4690400332456
"7220",2006-01-30,1,5,-121.4937566,38.61385305,7220,32267,4.4691135734072
"7221",2006-01-30,5,5,-121.4176962,38.46573597,7221,32272,4.46918709320039
"7222",2006-01-30,6,7,-121.4273504,38.54801719,7222,32279,4.46953752423151
"7223",2006-01-30,4,5,-121.4757806,38.55443881,7223,32284,4.469610964973
"7224",2006-01-30,5,7,-121.4133413,38.45718227,7224,32291,4.46996124031008
"7225",2006-01-30,1,5,-121.4699926,38.60301561,7225,32296,4.47003460207612
"7226",2006-01-30,5,4,-121.5000399,38.47894224,7226,32300,4.46996955438694
"7227",2006-01-30,3,2,-121.4118044,38.55563886,7227,32302,4.46962778469628
"7228",2006-01-30,2,1,-121.43772,38.61876519,7228,32303,4.4691477587161
"7229",2006-01-30,2,1,-121.4259738,38.60918188,7229,32304,4.46866786554157
"7230",2006-01-30,2,1,-121.4340925,38.62379457,7230,32305,4.46818810511757
"7231",2006-01-30,4,3,-121.532542,38.51348202,7231,32308,4.46798506430646
"7232",2006-01-30,6,3,-121.4409152,38.51750189,7232,32311,4.46778207964602
"7233",2006-01-30,4,3,-121.4895749,38.55118337,7233,32314,4.46757915111295
"7234",2006-01-30,4,6,-121.4990149,38.52199137,7234,32320,4.46779098700581
"7235",2006-01-30,4,6,-121.4990149,38.52199137,7235,32326,4.46800276434001
"7236",2006-01-30,5,3,-121.4898292,38.49506573,7236,32329,4.46779988944168
"7237",2006-01-30,6,7,-121.4402677,38.51181739,7237,32336,4.46814978582286
"7238",2006-01-30,2,8,-121.4487064,38.61112661,7238,32344,4.46863774523349
"7239",2006-01-30,3,4,-121.5064105,38.56958278,7239,32348,4.46857300732145
"7240",2006-01-30,3,4,-121.4382789,38.55849437,7240,32352,4.46850828729282
"7241",2006-01-30,6,1,-121.4239502,38.53736799,7241,32353,4.46802927772407
"7242",2006-01-30,4,7,-121.4990149,38.52199137,7242,32360,4.46837890085612
"7243",2006-01-30,6,4,-121.4509881,38.54751665,7243,32364,4.46831423443325
"7244",2006-01-30,2,1,-121.4464598,38.61155799,7244,32365,4.46783545002761
"7245",2006-01-30,5,5,-121.4561238,38.48843168,7245,32370,4.46790890269151
"7246",2006-01-30,5,5,-121.4574354,38.48778705,7246,32375,4.46798233508142
"7247",2006-01-30,6,1,-121.4538401,38.54675579,7247,32376,4.46750379467366
"7248",2006-01-30,2,7,-121.4258271,38.6017616,7248,32383,4.467853200883
"7249",2006-01-30,2,5,-121.4130839,38.63434706,7249,32388,4.46792661056698
"7250",2006-01-30,6,1,-121.4403543,38.54491473,7250,32389,4.46744827586207
"7251",2006-01-30,3,1,-121.4648897,38.57188611,7251,32390,4.46697007309337
"7252",2006-01-30,4,4,-121.5212433,38.49466185,7252,32394,4.4669056811914
"7253",2006-01-30,3,4,-121.495026,38.58187118,7253,32398,4.46684130704536
"7254",2006-01-30,5,4,-121.4569742,38.48870203,7254,32402,4.46677695064792
"7255",2006-01-30,2,1,-121.4508063,38.60931053,7255,32403,4.46629910406616
"7256",2006-01-30,4,4,-121.4960651,38.53085892,7256,32407,4.4662348401323
"7257",2006-01-30,6,5,-121.406008,38.51048773,7257,32412,4.46630839189748
"7258",2006-01-30,2,7,-121.4369795,38.64472998,7258,32419,4.46665748139983
"7259",2006-01-30,5,8,-121.4895978,38.4819803,7259,32427,4.46714423474308
"7260",2006-01-30,5,2,-121.4921192,38.49536962,7260,32429,4.4668044077135
"7261",2006-01-30,3,6,-121.442961,38.56797953,7261,32435,4.46701556259468
"7262",2006-01-30,3,3,-121.4977028,38.56986385,7262,32438,4.46681354998623
"7263",2006-01-30,3,5,-121.4864195,38.5873197,7263,32443,4.46688696131075
"7264",2006-01-30,2,7,-121.4291435,38.64733599,7264,32450,4.46723568281938
"7265",2006-01-30,2,5,-121.4212584,38.62142182,7265,32455,4.46730901582932
"7266",2006-01-30,5,4,-121.4127947,38.44082461,7266,32459,4.46724470134875
"7267",2006-01-30,3,5,-121.4130717,38.55505217,7267,32464,4.46731801293519
"7268",2006-01-30,3,8,-121.4094376,38.55767804,7268,32472,4.46780407264722
"7269",2006-01-30,6,7,-121.4367764,38.51447225,7269,32479,4.46815242811941
"7270",2006-01-30,2,4,-121.4569219,38.64124446,7270,32483,4.46808803301238
"7271",2006-01-30,5,8,-121.4530858,38.48230213,7271,32491,4.46857378627424
"7272",2006-01-30,5,1,-121.460074,38.49182496,7272,32492,4.46809680968097
"7273",2006-01-30,6,4,-121.422023,38.5305594,7273,32496,4.46803244878317
"7274",2006-01-30,5,5,-121.4411062,38.4716647,7274,32501,4.46810558152323
"7275",2006-01-30,2,7,-121.4593557,38.61302483,7275,32508,4.46845360824742
"7276",2006-01-30,5,1,-121.445934,38.47113601,7276,32509,4.46797691039032
"7277",2006-01-30,4,7,-121.5059719,38.50765729,7277,32516,4.46832485914525
"7278",2006-01-30,1,4,-121.501014,38.61354404,7278,32520,4.46826051112943
"7279",2006-01-30,2,7,-121.4504855,38.60778501,7279,32527,4.46860832531941
"7280",2006-01-30,4,7,-121.504483,38.55553457,7280,32534,4.46895604395604
"7281",2006-01-30,5,3,-121.4368769,38.47425283,7281,32537,4.46875429199286
"7282",2006-01-30,3,4,-121.4978798,38.59540732,7282,32541,4.46868992035155
"7283",2006-01-30,3,5,-121.4784008,38.56435251,7283,32546,4.46876287244267
"7284",2006-01-30,2,7,-121.4337087,38.62496247,7284,32553,4.46911037891268
"7285",2006-01-30,2,4,-121.4295032,38.60240036,7285,32557,4.46904598490048
"7286",2006-01-30,2,5,-121.4226745,38.65402327,7286,32562,4.469118858084
"7287",2006-01-30,2,5,-121.4650383,38.65049209,7287,32567,4.46919171126664
"7288",2006-01-30,5,3,-121.4181476,38.46391218,7288,32570,4.46899012074643
"7289",2006-01-30,2,3,-121.4149512,38.64187217,7289,32573,4.46878858553985
"7290",2006-01-30,1,4,-121.4767711,38.62824591,7290,32577,4.46872427983539
"7291",2006-01-30,5,2,-121.4349029,38.44824456,7291,32579,4.46838568097655
"7292",2006-01-30,6,7,-121.4390559,38.51481284,7292,32586,4.46873285792649
"7293",2006-01-30,3,3,-121.4484599,38.56245905,7293,32589,4.46853146853147
"7294",2006-01-30,5,1,-121.4189709,38.47433721,7294,32590,4.46805593638607
"7295",2006-01-30,5,5,-121.4196758,38.4748515,7295,32595,4.4681288553804
"7296",2006-01-30,5,5,-121.449973,38.4709823,7296,32600,4.46820175438596
"7297",2006-01-30,2,5,-121.4326425,38.65513243,7297,32605,4.46827463341099
"7298",2006-01-30,3,7,-121.5068254,38.57585352,7298,32612,4.46862154014799
"7299",2006-01-30,4,2,-121.4768614,38.50718879,7299,32614,4.46828332648308
"7300",2006-01-30,2,6,-121.3815598,38.63862878,7300,32620,4.46849315068493
"7301",2006-01-30,5,7,-121.4287887,38.47185437,7301,32627,4.46883988494727
"7302",2006-01-30,5,3,-121.4368769,38.47425283,7302,32630,4.46863872911531
"7303",2006-01-30,4,1,-121.4768614,38.50718879,7303,32631,4.46816376831439
"7304",2006-01-30,1,1,-121.5300211,38.61134232,7304,32632,4.46768893756846
"7305",2006-01-30,3,5,-121.4460281,38.57297265,7305,32637,4.46776180698152
"7306",2006-01-30,6,5,-121.4262594,38.50757216,7306,32642,4.46783465644676
"7307",2006-01-30,6,5,-121.4658441,38.53271689,7307,32647,4.46790748597236
"7308",2006-01-30,3,5,-121.4107516,38.54888945,7308,32652,4.4679802955665
"7309",2006-01-30,3,7,-121.4770709,38.56399777,7309,32659,4.4683267204816
"7310",2006-01-30,3,5,-121.4770709,38.56399777,7310,32664,4.46839945280438
"7311",2006-01-30,3,7,-121.486438,38.58280821,7311,32671,4.46874572561893
"7312",2006-01-30,3,7,-121.4790738,38.56654955,7312,32678,4.46909190371991
"7313",2006-01-30,6,8,-121.432622,38.52751169,7313,32686,4.469574729933
"7314",2006-01-30,6,2,-121.4418783,38.52530229,7314,32688,4.46923707957342
"7315",2006-01-30,3,7,-121.4668268,38.58086879,7315,32695,4.46958304853042
"7316",2006-01-30,6,4,-121.4680299,38.55417278,7316,32699,4.46951886276654
"7317",2006-01-30,5,5,-121.4771047,38.47968653,7317,32704,4.46959136258029
"7318",2006-01-30,5,5,-121.4585976,38.48148781,7318,32709,4.46966384257994
"7319",2006-01-30,5,5,-121.4585976,38.48148781,7319,32714,4.4697363027736
"7320",2006-01-30,3,2,-121.4665349,38.57312664,7320,32716,4.46939890710382
"7321",2006-01-30,4,5,-121.4785311,38.50488973,7321,32721,4.46947138369075
"7322",2006-01-30,1,4,-121.4729069,38.59789126,7322,32725,4.46940726577438
"7323",2006-01-30,2,4,-121.4226958,38.62070956,7323,32729,4.46934316536938
"7324",2006-01-30,1,3,-121.4776996,38.61380097,7324,32732,4.46914254505735
"7325",2006-01-30,3,7,-121.4844897,38.59390962,7325,32739,4.46948805460751
"7326",2006-01-30,6,1,-121.4581135,38.55496978,7326,32740,4.46901446901447
"7327",2006-01-30,4,2,-121.4758092,38.54531417,7327,32742,4.46867749419954
"7328",2006-01-30,2,2,-121.4447836,38.61332659,7328,32744,4.46834061135371
"7329",2006-01-30,6,6,-121.4724356,38.55612335,7329,32750,4.46854959748943
"7330",2006-01-30,2,2,-121.4569399,38.63015644,7330,32752,4.46821282401091
"7331",2006-01-30,5,5,-121.5024485,38.48972495,7331,32757,4.46828536352476
"7332",2006-01-30,6,7,-121.4430288,38.53330678,7332,32764,4.46863066012002
"7333",2006-01-30,6,1,-121.4182359,38.51912274,7333,32765,4.46815764352925
"7334",2006-01-30,1,8,-121.5177794,38.61543011,7334,32773,4.46863921461685
"7335",2006-01-30,3,4,-121.4045693,38.55310579,7335,32777,4.46857532379005
"7336",2006-01-30,2,7,-121.4291435,38.64733599,7336,32784,4.46892039258451
"7337",2006-01-30,6,2,-121.4397584,38.51881709,7337,32786,4.46858388987325
"7338",2006-01-30,4,6,-121.4949864,38.49705171,7338,32792,4.46879258653584
"7339",2006-01-30,6,1,-121.4538401,38.54675579,7339,32793,4.46831993459599
"7340",2006-01-31,6,7,-121.4462864,38.53698551,7340,32800,4.46866485013624
"7341",2006-01-31,4,4,-121.5097453,38.50065199,7341,32804,4.46860100803705
"7342",2006-01-31,6,4,-121.4425904,38.52497346,7342,32808,4.46853718332879
"7343",2006-01-31,2,5,-121.4570282,38.62775415,7343,32813,4.46860956012529
"7344",2006-01-31,4,7,-121.5300754,38.50274092,7344,32820,4.46895424836601
"7345",2006-01-31,3,5,-121.3920366,38.55512756,7345,32825,4.46902654867257
"7346",2006-01-31,3,7,-121.4426148,38.56931514,7346,32832,4.46937108630547
"7347",2006-01-31,5,6,-121.45918,38.4668574,7347,32838,4.4695794201715
"7348",2006-01-31,2,7,-121.4646863,38.62510152,7348,32845,4.46992378878606
"7349",2006-01-31,5,7,-121.452118,38.46728546,7349,32852,4.47026806368213
"7350",2006-01-31,2,7,-121.4336354,38.63903507,7350,32859,4.47061224489796
"7351",2006-01-31,2,5,-121.447871,38.62682119,7351,32864,4.47068426064481
"7352",2006-01-31,5,6,-121.4425544,38.47363779,7352,32870,4.4708922742111
"7353",2006-01-31,5,3,-121.4530858,38.48230213,7353,32873,4.47069223446212
"7354",2006-01-31,2,6,-121.4564172,38.65829986,7354,32879,4.47090019037259
"7355",2006-01-31,5,3,-121.5020171,38.48595292,7355,32882,4.4707002039429
"7356",2006-01-31,6,5,-121.435864,38.5105054,7356,32887,4.47077215878195
"7357",2006-01-31,6,1,-121.4497148,38.53941555,7357,32888,4.47030039418241
"7358",2006-01-31,4,1,-121.4827348,38.49575914,7358,32889,4.46982875781462
"7359",2006-01-31,2,1,-121.4461583,38.62018156,7359,32890,4.46935724962631
"7360",2006-01-31,3,6,-121.4976906,38.57905171,7360,32896,4.4695652173913
"7361",2006-01-31,5,5,-121.43352,38.48131274,7361,32901,4.46963727754381
"7362",2006-01-31,6,1,-121.4594336,38.54827585,7362,32902,4.4691659875034
"7363",2006-01-31,6,7,-121.4384157,38.55132811,7363,32909,4.46950971071574
"7364",2006-01-31,3,6,-121.4511566,38.57380164,7364,32915,4.4697175448126
"7365",2006-01-31,6,1,-121.446656,38.52493531,7365,32916,4.46924643584521
"7366",2006-01-31,2,7,-121.4128348,38.63484831,7366,32923,4.46959000814553
"7367",2006-01-31,3,1,-121.5027369,38.582786,7367,32924,4.46911904438713
"7368",2006-01-31,1,4,-121.4908145,38.62248985,7368,32928,4.46905537459283
"7369",2006-01-31,1,5,-121.4916679,38.61571113,7369,32933,4.46912742570227
"7370",2006-01-31,5,6,-121.4330732,38.47598615,7370,32939,4.46933514246947
"7371",2006-01-31,6,2,-121.4502184,38.54031312,7371,32941,4.4690001356668
"7372",2006-01-31,5,1,-121.4583773,38.48151149,7372,32942,4.46852957135106
"7373",2006-01-31,4,7,-121.5526223,38.50536483,7373,32949,4.46887291468873
"7374",2006-01-31,5,6,-121.4203656,38.46129545,7374,32955,4.46908055329536
"7375",2006-01-31,5,7,-121.4657533,38.47058126,7375,32962,4.46942372881356
"7376",2006-01-31,3,1,-121.4921151,38.57995276,7376,32963,4.46895336225597
"7377",2006-01-31,3,1,-121.4865462,38.57846736,7377,32964,4.46848312322082
"7378",2006-01-31,2,5,-121.4224441,38.61764108,7378,32969,4.46855516400108
"7379",2006-01-31,2,5,-121.4224441,38.61764108,7379,32974,4.46862718525546
"7380",2006-01-31,6,7,-121.4718637,38.54503537,7380,32981,4.4689701897019
"7381",2006-01-31,5,3,-121.4392225,38.46156147,7381,32984,4.46877116921826
"7382",2006-01-31,4,3,-121.4960208,38.55199422,7382,32987,4.46857220265511
"7383",2006-01-31,2,5,-121.4488659,38.66384943,7383,32992,4.46864418258161
"7384",2006-01-31,3,5,-121.4801842,38.56295187,7384,32997,4.46871614301192
"7385",2006-01-31,2,3,-121.4303283,38.63228581,7385,33000,4.4685172647258
"7386",2006-01-31,5,4,-121.4328002,38.4452549,7386,33004,4.46845383157325
"7387",2006-01-31,5,1,-121.4459825,38.45768385,7387,33005,4.46798429673751
"7388",2006-01-31,4,5,-121.4990149,38.52199137,7388,33010,4.46805630752572
"7389",2006-01-31,3,1,-121.4907988,38.57960099,7389,33011,4.46758695357965
"7390",2006-01-31,4,1,-121.5195591,38.52532421,7390,33012,4.46711772665765
"7391",2006-01-31,4,3,-121.5427657,38.51006027,7391,33015,4.46691922608578
"7392",2006-01-31,6,3,-121.4179521,38.50720937,7392,33018,4.46672077922078
"7393",2006-01-31,5,7,-121.4313832,38.448252,7393,33025,4.46706343838766
"7394",2006-01-31,2,7,-121.4211162,38.62039687,7394,33032,4.46740600486881
"7395",2006-01-31,4,1,-121.5346969,38.50298477,7395,33033,4.46693711967546
"7396",2006-01-31,3,3,-121.4558113,38.57026213,7396,33036,4.46673877771769
"7397",2006-01-31,6,3,-121.4623494,38.53580637,7397,33039,4.46654048938759
"7398",2006-01-31,3,2,-121.4825153,38.59548796,7398,33041,4.4662070829954
"7399",2006-01-31,1,5,-121.4700579,38.62201506,7399,33046,4.46627922692256
"7400",2006-01-31,3,1,-121.4976906,38.57905171,7400,33047,4.46581081081081
"7401",2006-01-31,5,4,-121.428879,38.45400615,7401,33051,4.4657478719092
"7402",2006-01-31,1,7,-121.4874437,38.62493534,7402,33058,4.46609024587949
"7403",2006-01-31,5,1,-121.4219209,38.44733459,7403,33059,4.46562204511684
"7404",2006-01-31,3,2,-121.4987842,38.58173099,7404,33061,4.46528903295516
"7405",2006-01-31,5,8,-121.4673944,38.49407763,7405,33069,4.46576637407157
"7406",2006-01-31,4,2,-121.4960208,38.55199422,7406,33071,4.46543343235215
"7407",2006-01-31,3,3,-121.5029953,38.59590993,7407,33074,4.46523558795734
"7408",2006-01-31,1,7,-121.5154134,38.61596119,7408,33081,4.4655777537797
"7409",2006-01-31,6,1,-121.4672495,38.54394604,7409,33082,4.46511000134971
"7410",2006-01-31,1,1,-121.541883,38.65798545,7410,33083,4.46464237516869
"7411",2006-01-31,3,5,-121.3941935,38.55027304,7411,33088,4.46471461341249
"7412",2006-01-31,4,2,-121.4990149,38.52199137,7412,33090,4.46438208310847
"7413",2006-01-31,3,1,-121.4977064,38.58078995,7413,33091,4.463914744368
"7414",2006-01-31,3,1,-121.495181,38.58320363,7414,33092,4.46344753169679
"7415",2006-01-31,4,7,-121.5443436,38.4873192,7415,33099,4.46378961564397
"7416",2006-01-31,6,3,-121.4424934,38.52709836,7416,33102,4.46359223300971
"7417",2006-01-31,1,3,-121.5055312,38.63589608,7417,33105,4.46339490359984
"7418",2006-01-31,6,3,-121.4647617,38.53952458,7418,33108,4.46319762739283
"7419",2006-01-31,3,1,-121.4970836,38.57881567,7419,33109,4.46273082625691
"7420",2006-01-31,3,5,-121.4784832,38.56122251,7420,33114,4.46280323450135
"7421",2006-01-31,3,7,-121.4963952,38.57870558,7421,33121,4.46314512868886
"7422",2006-01-31,6,4,-121.4664564,38.52749693,7422,33125,4.46308272702776
"7423",2006-01-31,6,3,-121.4606267,38.54679037,7423,33128,4.46288562575778
"7424",2006-01-31,5,8,-121.4161718,38.46337225,7424,33136,4.46336206896552
"7425",2006-01-31,3,1,-121.4984069,38.5791674,7425,33137,4.46289562289562
"7426",2006-01-31,5,5,-121.4764405,38.48928059,7426,33142,4.46296795044438
"7427",2006-01-31,1,6,-121.5161468,38.65847399,7427,33148,4.4631749023832
"7428",2006-01-31,6,5,-121.406008,38.51048773,7428,33153,4.46324717285945
"7429",2006-01-31,3,5,-121.4984069,38.5791674,7429,33158,4.46331942387939
"7430",2006-01-31,4,4,-121.5302541,38.50054764,7430,33162,4.46325706594886
"7431",2006-01-31,1,2,-121.4763493,38.63659439,7431,33164,4.46292558202126
"7432",2006-01-31,2,6,-121.4386769,38.61014482,7432,33170,4.46313240043057
"7433",2006-01-31,5,1,-121.4381341,38.45030055,7433,33171,4.46266648728643
"7434",2006-01-31,6,5,-121.4647076,38.53089383,7434,33176,4.46273876782351
"7435",2006-01-31,5,5,-121.4412033,38.44585327,7435,33181,4.46281102891728
"7436",2006-01-31,3,4,-121.4920245,38.58433488,7436,33185,4.46274878967187
"7437",2006-01-31,5,5,-121.4859396,38.48934244,7437,33190,4.46282102998521
"7438",2006-01-31,4,4,-121.4761358,38.55607425,7438,33194,4.46275880613068
"7439",2006-01-31,4,7,-121.479928,38.53908574,7439,33201,4.463099879016
"7440",2006-01-31,2,5,-121.431078,38.65545976,7440,33206,4.46317204301075
"7441",2006-01-31,3,6,-121.4870597,38.56543466,7441,33212,4.4633785781481
"7442",2006-01-31,3,4,-121.4983658,38.58003493,7442,33216,4.46331631281913
"7443",2006-01-31,5,5,-121.4767503,38.49278033,7443,33221,4.46338841864839
"7444",2006-01-31,1,5,-121.4952127,38.65733301,7444,33226,4.46346050510478
"7445",2006-01-31,3,5,-121.4747245,38.56821865,7445,33231,4.4635325721961
"7446",2006-01-31,2,4,-121.4313425,38.62538748,7446,33235,4.4634703196347
"7447",2006-01-31,5,1,-121.4270863,38.47245555,7447,33236,4.46300523700819
"7448",2006-01-31,3,5,-121.4848357,38.57555181,7448,33241,4.46307733619764
"7449",2006-01-31,5,6,-121.4859396,38.48934244,7449,33247,4.46328366223654
"7450",2006-01-31,4,5,-121.4915289,38.51153512,7450,33252,4.46335570469799
"7451",2006-01-31,4,3,-121.476769,38.54459359,7451,33255,4.46315930747551
"7452",2006-01-31,6,4,-121.4127166,38.50939065,7452,33259,4.46309715512614
"7453",2006-01-31,4,7,-121.4908853,38.5488551,7453,33266,4.46343754192942
"7454",2006-01-31,2,4,-121.422466,38.63956757,7454,33270,4.46337536892943
"7455",2006-01-31,4,6,-121.5346969,38.50298477,7455,33276,4.4635814889336
"7456",2006-01-31,6,7,-121.4254625,38.54146972,7456,33283,4.46392167381974
"7457",2006-01-31,3,1,-121.4944195,38.57810659,7457,33284,4.46345715435162
"7458",2006-01-31,5,6,-121.4336564,38.46895114,7458,33290,4.46366318047734
"7459",2006-01-31,3,5,-121.4839757,38.59530776,7459,33295,4.46373508513205
"7460",2006-01-31,4,8,-121.4960208,38.55199422,7460,33303,4.4642091152815
"7461",2006-01-31,4,3,-121.5346969,38.50298477,7461,33306,4.46401286690792
"7462",2006-01-31,5,5,-121.42717,38.47421612,7462,33311,4.46408469579201
"7463",2006-01-31,4,1,-121.4792852,38.55531685,7463,33312,4.46362052793783
"7464",2006-01-31,2,6,-121.4258404,38.63618486,7464,33318,4.46382636655949
"7465",2006-01-31,3,5,-121.4095408,38.54858671,7465,33323,4.46389819156062
"7466",2006-01-31,2,3,-121.3815598,38.63862878,7466,33326,4.46370211626038
"7467",2006-01-31,6,5,-121.4345667,38.50971647,7467,33331,4.46377393866345
"7468",2006-01-31,2,7,-121.4494618,38.61845089,7468,33338,4.46411355115158
"7469",2006-01-31,3,2,-121.481959,38.5906691,7469,33340,4.46378363904137
"7470",2006-01-31,3,1,-121.4892102,38.57917936,7470,33341,4.46331994645248
"7471",2006-01-31,2,1,-121.4499784,38.60819724,7471,33342,4.46285637799491
"7472",2006-01-31,5,1,-121.4328289,38.44604313,7472,33343,4.46239293361884
"7473",2006-01-31,5,5,-121.4698358,38.4993693,7473,33348,4.46246487354476
"7474",2006-01-31,3,6,-121.4884229,38.58506592,7474,33354,4.46267059138346
"7475",2006-01-31,3,2,-121.4859804,38.58319335,7475,33356,4.46234113712375
"7476",2006-01-31,6,6,-121.4402677,38.51181739,7476,33362,4.4625468164794
"7477",2006-01-31,6,4,-121.4561023,38.54631611,7477,33366,4.4624849538585
"7478",2006-01-31,5,6,-121.4859396,38.48934244,7478,33372,4.46269055897299
"7479",2006-01-31,5,1,-121.4449392,38.48049217,7479,33373,4.46222757053082
"7480",2006-01-31,4,4,-121.4845198,38.52971517,7480,33377,4.46216577540107
"7481",2006-01-31,5,9,-121.4405437,38.46232027,7481,33386,4.46277235663681
"7482",2006-01-31,2,2,-121.425515,38.64006876,7482,33388,4.46244319700615
"7483",2006-01-31,5,7,-121.4330297,38.46781949,7483,33395,4.46278230656154
"7484",2006-01-31,2,1,-121.4258271,38.6017616,7484,33396,4.46231961517905
"7485",2006-01-31,2,7,-121.4487064,38.61112661,7485,33403,4.4626586506346
"7486",2006-01-31,3,7,-121.4679502,38.56767147,7486,33410,4.46299759551162
"7487",2006-01-31,2,7,-121.4252477,38.60027317,7487,33417,4.4633364498464
"7488",2006-01-31,2,5,-121.436798,38.61141805,7488,33422,4.46340811965812
"7489",2006-01-31,5,1,-121.4312631,38.46377975,7489,33423,4.46294565362532
"7490",2006-01-31,3,1,-121.4829511,38.57785824,7490,33424,4.46248331108144
"7491",2006-01-31,6,6,-121.4546045,38.55426406,7491,33430,4.46268855960486
"7492",2006-01-31,6,1,-121.4671318,38.55128541,7492,33431,4.46222637479979
"7493",2006-01-31,6,1,-121.4345829,38.53945518,7493,33432,4.46176431335914
"7494",2006-01-31,6,4,-121.4673037,38.54792791,7494,33436,4.46170269548973
"7495",2006-01-31,5,7,-121.4111095,38.44026684,7495,33443,4.46204136090727
"7496",2006-01-31,3,7,-121.4912564,38.58264276,7496,33450,4.46237993596585
"7497",2006-01-31,5,5,-121.4256049,38.4742413,7497,33455,4.4624516473256
"7498",2006-01-31,1,4,-121.4978558,38.61273956,7498,33459,4.46238997065884
"7499",2006-01-31,2,6,-121.4249803,38.60522828,7499,33465,4.46259501266836
"7500",2006-01-31,6,1,-121.4689017,38.53477121,7500,33466,4.46213333333333
"7501",2006-01-31,6,3,-121.4703155,38.55247254,7501,33469,4.46193840821224
"7502",2006-01-31,3,6,-121.4868341,38.58464151,7502,33475,4.46214342841909
"7503",2006-01-31,3,6,-121.415297,38.57411211,7503,33481,4.46234839397574
"7504",2006-01-31,3,1,-121.4890397,38.5692795,7504,33482,4.46188699360341
"7505",2006-01-31,1,4,-121.4946355,38.68094,7505,33486,4.4618254497002
"7506",2006-01-31,6,5,-121.4382432,38.54969892,7506,33491,4.46189714894751
"7507",2006-01-31,1,3,-121.4798565,38.61078466,7507,33494,4.46170241108299
"7508",2006-01-31,1,8,-121.4959999,38.63020663,7508,33502,4.4621736814065
"7509",2006-01-31,2,2,-121.4461937,38.61112011,7509,33504,4.46184578505793
"7510",2006-01-31,6,1,-121.4652804,38.54775932,7510,33505,4.46138482023968
"7511",2006-01-31,4,3,-121.4963791,38.56266375,7511,33508,4.4611902542937
"7512",2006-01-31,4,4,-121.4887485,38.50790371,7512,33512,4.46112886048988
"7513",2006-01-31,2,7,-121.4256455,38.64341672,7513,33519,4.46146679089578
"7514",2006-01-31,1,3,-121.4700579,38.62201506,7514,33522,4.46127229172212
"7515",2006-01-31,4,4,-121.4931325,38.55640256,7515,33526,4.46121091151031
"7516",2006-01-31,5,8,-121.4177615,38.43799945,7516,33534,4.46168174560937
"7517",2006-01-31,6,6,-121.4438874,38.52496323,7517,33540,4.46188639084741
"7518",2006-01-31,1,5,-121.4700221,38.60799414,7518,33545,4.46195796754456
"7519",2006-01-31,3,5,-121.469824,38.56214425,7519,33550,4.46202952520282
"7520",2006-01-31,3,5,-121.4067055,38.54978318,7520,33555,4.46210106382979
"7521",2006-01-31,3,5,-121.4678719,38.57348427,7521,33560,4.46217258343305
"7522",2006-01-31,3,3,-121.4944065,38.57402607,7522,33563,4.46197819728796
"7523",2006-01-31,6,6,-121.4438874,38.52496323,7523,33569,4.46218263990429
"7524",2006-01-31,1,7,-121.4918727,38.61300454,7524,33576,4.46251993620415
"7525",2006-01-31,2,2,-121.4646457,38.60254068,7525,33578,4.4621926910299
"7526",2006-01-31,3,5,-121.5047263,38.57741524,7526,33583,4.4622641509434
"7527",2006-01-31,6,7,-121.4401734,38.52875394,7527,33590,4.46260130197954
"7528",2006-01-31,5,3,-121.4868595,38.48142174,7528,33593,4.46240701381509
"7529",2006-01-31,2,4,-121.4303204,38.61925076,7529,33597,4.46234559702484
"7530",2006-01-31,3,4,-121.4150012,38.56666634,7530,33601,4.46228419654715
"7531",2006-01-31,6,1,-121.4318683,38.52206826,7531,33602,4.4618244589032
"7532",2006-01-31,5,2,-121.4420968,38.48346882,7532,33604,4.46149761019649
"7533",2006-01-31,6,2,-121.470546,38.54120974,7533,33606,4.46117084826762
"7534",2006-01-31,5,6,-121.448452,38.47435531,7534,33612,4.46137509954871
"7535",2006-01-31,5,3,-121.4919864,38.49340569,7535,33615,4.46118115461181
"7536",2006-01-31,3,1,-121.491401,38.56382548,7536,33616,4.46072186836518
"7537",2006-01-31,5,5,-121.4561774,38.48001012,7537,33621,4.46079341913228
"7538",2006-01-31,5,5,-121.4340917,38.46734964,7538,33626,4.46086495091536
"7539",2006-01-31,5,5,-121.4654193,38.48160193,7539,33631,4.46093646372198
"7540",2006-01-31,3,5,-121.3956435,38.54711178,7540,33636,4.46100795755968
"7541",2006-01-31,3,3,-121.482551,38.57948479,7541,33639,4.46081421562127
"7542",2006-01-31,6,7,-121.4456482,38.52823386,7542,33646,4.46115088835853
"7543",2006-01-31,3,7,-121.4539863,38.5751825,7543,33653,4.46148747182819
"7544",2006-01-31,6,7,-121.4598901,38.55218546,7544,33660,4.46182396606575
"7545",2006-01-31,5,3,-121.4368769,38.47425283,7545,33663,4.46163021868787
"7546",2006-01-31,6,5,-121.4268035,38.50510076,7546,33668,4.46170156374238
"7547",2006-01-31,2,5,-121.4420038,38.62686447,7547,33673,4.46177288989002
"7548",2006-01-31,2,5,-121.4598632,38.63519792,7548,33678,4.46184419713831
"7549",2006-01-31,5,3,-121.427181,38.46849636,7549,33681,4.46165054974169
"7550",2006-01-31,3,7,-121.4045564,38.55255654,7550,33688,4.46198675496689
"7551",2006-01-31,6,5,-121.4397584,38.51881709,7551,33693,4.46205800556218
"7552",2006-01-31,2,4,-121.4311882,38.61006984,7552,33697,4.4619968220339
"7553",2006-01-31,3,7,-121.4657048,38.57934786,7553,33704,4.46233284787502
"7554",2006-01-31,2,5,-121.4381004,38.6051444,7554,33709,4.46240402435796
"7555",2006-01-31,6,7,-121.4362512,38.51546647,7555,33716,4.46273990734613
"7556",2006-01-31,5,7,-121.4288621,38.47185474,7556,33723,4.46307570142933
"7557",2006-01-31,2,5,-121.4450354,38.6092995,7557,33728,4.46314675135636
"7558",2006-01-31,2,7,-121.4476543,38.61140992,7558,33735,4.46348240275205
"7559",2006-01-31,5,5,-121.4349815,38.44316219,7559,33740,4.46355338007673
"7560",2006-01-31,6,5,-121.4647018,38.53213497,7560,33745,4.46362433862434
"7561",2006-01-31,6,8,-121.4514558,38.53942931,7561,33753,4.46409205131596
"7562",2006-01-31,6,1,-121.4578018,38.54674696,7562,33754,4.46363395927003
"7563",2006-01-31,3,8,-121.4877874,38.58245172,7563,33762,4.46410154700516
"7564",2006-01-31,6,3,-121.470547,38.53918049,7564,33765,4.46390798519302
"7565",2006-01-31,6,3,-121.435864,38.5105054,7565,33768,4.46371447455387
"7566",2006-01-31,3,4,-121.4445357,38.56428007,7566,33772,4.46365318530267
"7567",2006-01-31,3,4,-121.4850301,38.57236464,7567,33776,4.46359191225056
"7568",2006-01-31,3,4,-121.5024184,38.5833091,7568,33780,4.46353065539112
"7569",2006-01-31,3,5,-121.4885667,38.57037029,7569,33785,4.46360153256705
"7570",2006-01-31,6,1,-121.4697841,38.55199506,7570,33786,4.46314398943197
"7571",2006-01-31,4,2,-121.4917337,38.55346102,7571,33788,4.46281865011227
"7572",2006-01-31,2,3,-121.4381202,38.61106201,7572,33791,4.46262546222927
"7573",2006-01-31,6,5,-121.4693916,38.55634283,7573,33796,4.46269642149742
"7574",2006-01-31,6,7,-121.466571,38.55378987,7574,33803,4.4630314232902
"7575",2006-01-31,2,7,-121.4441675,38.63444543,7575,33810,4.46336633663366
"7576",2006-01-31,6,4,-121.4477075,38.55665053,7576,33814,4.46330517423442
"7577",2006-01-31,2,1,-121.4221738,38.63458772,7577,33815,4.46284809291276
"7578",2006-01-31,3,5,-121.4106352,38.55790107,7578,33820,4.46291897598311
"7579",2006-01-31,6,8,-121.4597445,38.5566387,7579,33828,4.46338567093284
"7580",2006-01-31,3,4,-121.4704595,38.57783198,7580,33832,4.46332453825858
"7581",2006-01-31,4,7,-121.4925914,38.53759051,7581,33839,4.46365914786967
"7582",2006-01-31,3,5,-121.4670118,38.57203045,7582,33844,4.46372988657346
"7583",2006-01-31,4,3,-121.4712477,38.52718667,7583,33847,4.46353685876302
"7584",2006-01-31,4,3,-121.5286345,38.47962803,7584,33850,4.46334388185654
